Location,Year, Net earnings by place of residence(Thousands of dollars), Personal current transfer receipts(Thousands of dollars),  Income maintenance benefits 1/(Thousands of dollars),  Unemployment insurance compensation(Thousands of dollars),  Retirement and other(Thousands of dollars)," Dividends, interest, and rent 2/(Thousands of dollars)", Population (persons) 3/(Number of persons), Per capita personal income 4/(Dollars), Per capita net earnings 4/(Dollars), Per capita personal current transfer receipts 4/(Dollars),  Per capita income maintenance benefits 4/(Dollars),  Per capita unemployment insurance compensation 4/(Dollars),  Per capita retirement and other 4/(Dollars)," Per capita dividends, interest, and rent 4/(Dollars)", Earnings by place of work(Thousands of dollars),  Wages and salaries(Thousands of dollars),  Supplements to wages and salaries(Thousands of dollars),   Employer contributions for employee pension and insurance funds 5/(Thousands of dollars),   Employer contributions for government social insurance(Thousands of dollars),  Proprietors' income(Thousands of dollars),   Farm proprietors' income(Thousands of dollars),   Nonfarm proprietors' income(Thousands of dollars),Total employment (number of jobs)(Number of jobs), Wage and salary employment(Number of jobs), Proprietors employment(Number of jobs),  Farm proprietors employment 6/(Number of jobs),  Nonfarm proprietors employment(Number of jobs),Average earnings per job (dollars)(Dollars), Average wages and salaries(Dollars), Average nonfarm proprietors' income(Dollars)
"Angelina, TX",2001,1208084,367525,34357,6629,326539,328077,80273,23715,15050,4578,428,83,4068,4087,1410715,1005670,226261,156824,69437,178784,5702,173082,45279,37510,7769,967,6802,31156,26811,25446
"Angelina, TX",2002,1243683,401729,41272,11058,349399,313983,80803,24249,15392,4972,511,137,4324,3886,1439557,1011305,236411,167565,68846,191841,6901,184940,45313,37406,7907,908,6999,31769,27036,26424
"Angelina, TX",2003,1290815,433073,47089,10690,375294,312656,81510,24985,15836,5313,578,131,4604,3836,1495570,1047359,258797,182312,76485,189414,6165,183249,45508,37601,7907,916,6991,32864,27855,26212
"Angelina, TX",2004,1357632,456691,50301,7293,399097,297946,82070,25737,16542,5565,613,89,4863,3630,1571361,1120461,269495,188298,81197,181405,5188,176217,46310,37972,8338,913,7425,33931,29508,23733
"Angelina, TX",2005,1395134,497516,58146,4917,434453,314246,82553,26733,16900,6027,704,60,5263,3807,1609069,1159628,281191,197943,83248,168250,3,168247,46453,37814,8639,939,7700,34639,30667,21850
"Angelina, TX",2006,1483929,530496,58031,4025,468440,346468,83810,28170,17706,6330,692,48,5589,4134,1697264,1234120,293936,208775,85161,169208,-1444,170652,47914,38956,8958,938,8020,35423,31680,21278
"Angelina, TX",2007,1542807,577099,60167,4264,512668,393445,84518,29737,18254,6828,712,50,6066,4655,1751524,1290274,295016,208504,86512,166234,519,165715,48390,39219,9171,1022,8149,36196,32899,20336
"Angelina, TX",2008,1589495,633009,68525,6469,558015,435490,84961,31285,18709,7451,807,76,6568,5126,1789111,1317763,293054,206117,86937,178294,-7465,185759,47990,38598,9392,994,8398,37281,34141,22119
"Angelina, TX",2009,1528570,694239,77562,22367,594310,400580,86029,30494,17768,8070,902,260,6908,4656,1737924,1257805,296855,211814,85041,183264,-6125,189389,46537,37005,9532,971,8561,37345,33990,22122
"Angelina, TX",2010,1578179,755866,86359,22791,646716,387347,86903,31315,18160,8698,994,262,7442,4457,1809056,1279749,312860,222347,90513,216447,2801,213646,46238,36879,9359,953,8406,39125,34701,25416
"Angelina, TX",2011,1704516,772470,87046,17290,668134,427046,87282,33272,19529,8850,997,198,7655,4893,1951681,1387758,316481,219212,97269,247442,-3747,251189,47150,37355,9795,932,8863,41393,37151,28341
"Angelina, TX",2012,1822257,768135,86488,14476,667171,490684,87496,35214,20827,8779,988,165,7625,5608,2111933,1508799,334094,231004,103090,269040,1828,267212,47441,37930,9511,898,8613,44517,39779,31024
"Angelina, TX",2013,1763184,794800,86246,11054,697500,477388,87365,34744,20182,9097,987,127,7984,5464,2074384,1432948,344434,244845,99589,297002,8267,288735,47928,38029,9899,901,8998,43281,37680,32089
"Angelina, TX",2014,1918909,824539,86496,7208,730835,521726,87601,37273,21905,9412,987,82,8343,5956,2245707,1483769,354071,252207,101864,407867,9333,398534,48624,38517,10107,891,9216,46185,38522,43244
"Angelina, TX",2015,1912367,866742,85402,11725,769615,572782,87901,38133,21756,9860,972,133,8755,6516,2253403,1503035,364339,260261,104078,386029,15174,370855,48701,38418,10283,870,9413,46270,39123,39398
"Angelina, TX",2016,1799413,911581,86958,11635,812988,581279,87830,37485,20487,10379,990,132,9256,6618,2129716,1458928,353567,251509,102058,317221,5065,312156,48239,37681,10558,867,9691,44149,38718,32211
"Angelina, TX",2017,1766522,922211,88143,7774,826294,608820,87805,37555,20119,10503,1004,89,9411,6934,2103179,1478601,359378,255207,104171,265200,7829,257371,48183,37413,10770,862,9908,43650,39521,25976
"Aransas, TX",2001,309474,111563,9602,1928,100033,137286,22287,25052,13886,5006,431,87,4488,6160,211119,133810,29893,20884,9009,47416,-1598,49014,9192,6068,3124,65,3059,22968,22052,16023
"Aransas, TX",2002,313713,119104,10297,2591,106216,133606,22616,25045,13871,5266,455,115,4696,5908,211688,131367,30309,21371,8938,50012,-2200,52212,9120,5938,3182,62,3120,23211,22123,16735
"Aransas, TX",2003,324612,130047,11353,3248,115446,131478,22843,25659,14211,5693,497,142,5054,5756,228479,141042,33677,23522,10155,53760,-2024,55784,9421,6138,3283,64,3219,24252,22978,17330
"Aransas, TX",2004,343155,142006,12414,2602,126990,149959,23067,27534,14876,6156,538,113,5505,6501,251358,148524,36458,25717,10741,66376,-1825,68201,9585,6161,3424,68,3356,26224,24107,20322
"Aransas, TX",2005,363165,159307,13804,1418,144085,174328,23561,29574,15414,6761,586,60,6115,7399,266466,158057,37394,26072,11322,71015,-1764,72779,9885,6334,3551,72,3479,26957,24954,20920
"Aransas, TX",2006,388679,174003,13718,1156,159129,182642,23395,31858,16614,7438,586,49,6802,7807,301048,182443,43387,31053,12334,75218,-1768,76986,10436,6740,3696,75,3621,28847,27069,21261
"Aransas, TX",2007,391533,188006,13820,1147,173039,205631,23172,33884,16897,8113,596,49,7468,8874,295452,187401,41809,29077,12732,66242,-1209,67451,10527,6601,3926,83,3843,28066,28390,17552
"Aransas, TX",2008,408806,208342,15720,1784,190838,214901,23225,35826,17602,8971,677,77,8217,9253,309289,196210,41434,28410,13024,71645,-1606,73251,10688,6723,3965,85,3880,28938,29185,18879
"Aransas, TX",2009,397941,223338,18581,5320,199437,198285,23291,35188,17086,9589,798,228,8563,8513,291569,186034,42608,30114,12494,62927,-1464,64391,10295,6398,3897,86,3811,28321,29077,16896
"Aransas, TX",2010,432000,241574,20247,6343,214984,195928,23181,37509,18636,10421,873,274,9274,8452,316044,192419,44468,30813,13655,79157,-1841,80998,10363,6423,3940,88,3852,30497,29958,21028
"Aransas, TX",2011,470489,254408,20260,4889,229259,212071,23228,40338,20255,10953,872,210,9870,9130,343324,199567,44321,30187,14134,99436,-2011,101447,10368,6354,4014,89,3925,33114,31408,25846
"Aransas, TX",2012,531306,253788,19548,3610,230630,254485,23462,44309,22645,10817,833,154,9830,10847,374364,215523,48986,33552,15434,109855,-1960,111815,10742,6673,4069,90,3979,34850,32298,28101
"Aransas, TX",2013,557147,259763,19725,2943,237095,264606,23897,45257,23315,10870,825,123,9922,11073,387428,231410,52891,36697,16194,103127,-2047,105174,11231,7005,4226,91,4135,34496,33035,25435
"Aransas, TX",2014,601900,271036,19651,1897,249488,270119,24581,46502,24486,11026,799,77,10150,10989,402897,246705,55410,38337,17073,100782,-1889,102671,11252,7020,4232,90,4142,35807,35143,24788
"Aransas, TX",2015,604441,286488,19368,2481,264639,282495,24834,47251,24339,11536,780,100,10656,11375,399743,253417,58443,41061,17382,87883,-1981,89864,11410,7146,4264,88,4176,35034,35463,21519
"Aransas, TX",2016,549549,300952,19648,2942,278362,257167,25275,43825,21743,11907,777,116,11013,10175,390088,252155,57725,40056,17669,80208,-1967,82175,11232,7189,4043,88,3955,34730,35075,20777
"Aransas, TX",2017,564089,312792,23618,2921,286253,269257,25572,44820,22059,12232,924,114,11194,10529,369548,236501,55631,39018,16613,77416,-2215,79631,10767,6633,4134,87,4047,34322,35655,19677
"Baldwin, AL",2001,2436262,590585,35629,8405,546551,902088,144875,27119,16816,4077,246,58,3773,6227,1818931,1257443,284992,189849,95143,276496,-749,277245,70661,53718,16943,1114,15829,25742,23408,17515
"Baldwin, AL",2002,2524313,650570,41261,11333,597976,879480,147957,27402,17061,4397,279,77,4042,5944,1925758,1326833,303810,203037,100773,295115,-8034,303149,71892,54511,17381,987,16394,26787,24341,18491
"Baldwin, AL",2003,2670561,710069,46368,11190,652511,869172,151509,28050,17626,4687,306,74,4307,5737,2063918,1409883,331945,224050,107895,322090,6538,315552,73844,56178,17666,949,16717,27950,25097,18876
"Baldwin, AL",2004,2905467,782483,59792,8491,714200,1052904,156266,30338,18593,5007,383,54,4570,6738,2283876,1539467,371261,254605,116656,373148,4978,368170,77691,58567,19124,908,18216,29397,26286,20211
"Baldwin, AL",2005,3214283,848385,60698,7448,780239,1174494,162183,32292,19819,5231,374,46,4811,7242,2585394,1709193,408463,278599,129864,467738,-3504,471242,82612,61348,21264,896,20368,31296,27861,23136
"Baldwin, AL",2006,3548105,928616,58233,6570,863813,1371159,168121,34784,21104,5523,346,39,5138,8156,2905157,1914891,426787,285847,140940,563479,3095,560384,87768,64775,22993,870,22123,33100,29562,25330
"Baldwin, AL",2007,3705193,1007781,67102,7092,933587,1502362,172404,36051,21491,5845,389,41,5415,8714,3010367,2067299,457381,305848,151533,485687,-1564,487251,92728,68195,24533,979,23554,32464,30315,20687
"Baldwin, AL",2008,3662845,1141954,70757,11210,1059987,1481240,175827,35751,20832,6495,402,64,6029,8424,2871664,2113709,471021,315696,155325,286934,-5250,292184,92684,68177,24507,948,23559,30983,31003,12402
"Baldwin, AL",2009,3625210,1255988,92244,34628,1129116,1343769,179406,34698,20207,7001,514,193,6294,7490,2721074,1999571,478837,330994,147843,242666,945,241721,89324,64680,24644,922,23722,30463,30915,10190
"Baldwin, AL",2010,3814502,1441178,109557,40737,1290884,1387883,183110,36282,20832,7871,598,222,7050,7580,2799688,2000662,487721,332314,155407,311305,-8550,319855,89246,63795,25451,906,24545,31370,31361,13031
"Baldwin, AL",2011,4109280,1484827,114978,32134,1337715,1457559,186534,37804,22030,7960,616,172,7171,7814,2907152,2060271,499507,337777,161730,347374,-3372,350746,92000,65394,26606,881,25725,31599,31506,13634
"Baldwin, AL",2012,4248007,1503447,118105,22696,1362646,1502006,190048,38166,22352,7911,621,119,7170,7903,3017308,2128293,480480,316018,164462,408535,122,408413,93226,66218,27008,833,26175,32366,32141,15603
"Baldwin, AL",2013,4385815,1572417,123562,15802,1433053,1483086,194736,38212,22522,8075,635,81,7359,7616,3234413,2239598,510208,338056,172152,484607,26002,458605,96471,68352,28119,846,27273,33527,32766,16815
"Baldwin, AL",2014,4602407,1670285,126945,9254,1534086,1602542,199064,39561,23120,8391,638,46,7706,8050,3430467,2368668,548311,368769,179542,513488,3654,509834,99837,70747,29090,845,28245,34361,33481,18050
"Baldwin, AL",2015,4911148,1768065,125954,8158,1633953,1721651,202863,41412,24209,8716,621,40,8054,8487,3665610,2531374,594097,403569,190528,540139,-2105,542244,103943,73835,30108,842,29266,35266,34284,18528
"Baldwin, AL",2016,5272315,1868304,126762,8052,1733490,1783054,207509,43004,25408,9003,611,39,8354,8593,3891167,2667390,618692,422645,196047,605085,5208,599877,107855,76474,31381,857,30524,36078,34880,19653
"Baldwin, AL",2017,5578263,1938254,122971,6809,1808474,1855948,212628,44079,26235,9116,578,32,8505,8729,4139608,2817342,649866,443572,206294,672400,8331,664069,110457,78525,31932,848,31084,37477,35878,21364
"Bay County, FL",2001,2407072,670970,55225,10839,604906,931983,150207,26697,16025,4467,368,72,4027,6205,2767625,1976890,469892,330047,139845,320843,610,320233,84003,69972,14031,114,13917,32947,28253,23010
"Bay County, FL",2002,2607382,739816,60719,16265,662832,890813,152741,27746,17071,4844,398,106,4340,5832,2998538,2119474,535194,385238,149956,343870,459,343411,85801,71496,14305,111,14194,34948,29645,24194
"Bay County, FL",2003,2819867,794250,67624,15684,710942,927026,155044,29289,18188,5123,436,101,4585,5979,3239370,2285042,598616,436063,162553,355712,264,355448,87915,73280,14635,107,14528,36847,31182,24466
"Bay County, FL",2004,3033278,849977,77287,9929,762761,1013363,158804,30834,19101,5352,487,63,4803,6381,3497390,2486360,651958,472230,179728,359072,178,358894,93082,77502,15580,104,15476,37573,32081,23190
"Bay County, FL",2005,3309245,910204,93594,8226,808384,1092419,162917,32605,20312,5587,574,50,4962,6705,3834420,2735598,716112,518486,197626,382710,205,382505,97038,80511,16527,104,16423,39515,33978,23291
"Bay County, FL",2006,3553607,961382,89690,8207,863485,1191678,165644,34451,21453,5804,541,50,5213,7194,4118033,2947041,725899,508714,217185,445093,59,445034,100143,83013,17130,101,17029,41122,35501,26134
"Bay County, FL",2007,3528582,1017523,89567,9858,918098,1351846,165345,35671,21341,6154,542,60,5553,8176,4086851,2982734,742797,525898,216899,361320,65,361255,100794,82430,18364,120,18244,40547,36185,19801
"Bay County, FL",2008,3543208,1159220,100811,18528,1039881,1395098,166267,36673,21310,6972,606,111,6254,8391,4103972,2988025,763891,546114,217777,352056,-66,352122,99109,81267,17842,113,17729,41409,36768,19861
"Bay County, FL",2009,3424220,1263422,121384,48161,1093877,1235927,167464,35372,20447,7544,725,288,6532,7380,3978507,2918768,751560,534015,217545,308179,-56,308235,96101,78081,18020,109,17911,41399,37381,17209
"Bay County, FL",2010,3532153,1424918,141477,52933,1230508,1267804,169207,36789,20875,8421,836,313,7272,7493,4104614,2987129,799598,571998,227600,317887,-29,317916,95619,77471,18148,105,18043,42927,38558,17620
"Bay County, FL",2011,3569879,1473075,143154,42178,1287743,1359443,169521,37768,21059,8690,844,249,7596,8019,4079017,3001097,776266,543694,232572,301654,-69,301723,96586,77704,18882,101,18781,42232,38622,16065
"Bay County, FL",2012,3624304,1441968,148037,30056,1263875,1363716,171755,37437,21102,8395,862,175,7359,7940,4130940,3008839,780162,540633,239529,341939,-82,342021,96974,78217,18757,97,18660,42598,38468,18329
"Bay County, FL",2013,3680166,1485086,153040,21066,1310980,1356403,174626,37346,21075,8504,876,121,7507,7767,4229494,3080377,805636,563975,241661,343481,-69,343550,98845,79440,19405,97,19308,42789,38776,17793
"Bay County, FL",2014,3893469,1578583,153687,12126,1412770,1457520,178221,38882,21846,8857,862,68,7927,8178,4487884,3286487,837666,581234,256432,363731,-56,363787,102764,82356,20408,97,20311,43672,39906,17911
"Bay County, FL",2015,4105096,1651331,152436,6857,1492038,1586217,181184,40526,22657,9114,841,38,8235,8755,4730122,3460203,882889,620159,262730,387030,-60,387090,105201,84779,20422,94,20328,44963,40814,19042
"Bay County, FL",2016,4193713,1715958,144771,5258,1565929,1652915,182992,41327,22917,9377,791,29,8557,9033,4868275,3594470,883898,617070,266828,389907,-60,389967,107042,85950,21092,94,20998,45480,41820,18572
"Bay County, FL",2017,4277056,1795474,151678,4992,1638804,1724445,183563,42476,23300,9781,826,27,8928,9394,4968070,3659824,898679,629411,269268,409567,-59,409626,107591,86113,21478,94,21384,46176,42500,19156
"Calcasieu, LA",2001,2938043,802082,73911,9890,718281,762393,183296,24564,16029,4376,403,54,3919,4159,3510565,2636138,662996,486095,176901,211431,2830,208601,102944,88344,14600,894,13706,34102,29839,15220
"Calcasieu, LA",2002,3006887,837694,87677,15704,734313,755472,183487,25070,16387,4565,478,86,4002,4117,3612062,2716452,671939,488354,183585,223671,-480,224151,103511,88689,14822,767,14055,34895,30629,15948
"Calcasieu, LA",2003,3052979,855491,93103,16976,745412,710190,184701,25006,16529,4632,504,92,4036,3845,3655579,2737500,703859,519031,184828,214220,2289,211931,103169,87576,15593,748,14845,35433,31259,14276
"Calcasieu, LA",2004,3222249,932819,102535,12836,817448,689793,185593,26105,17362,5026,552,69,4405,3717,3874886,2853926,731726,542361,189365,289234,2718,286516,102337,87126,15211,730,14481,37864,32756,19786
"Calcasieu, LA",2005,3462041,1094781,176605,22792,895384,733765,186417,28380,18571,5873,947,122,4803,3936,4174365,3071776,780512,584749,195763,322077,-141,322218,104860,89117,15743,732,15011,39809,34469,21465
"Calcasieu, LA",2006,3736646,1046756,105885,13283,927588,963348,185350,31005,20160,5647,571,72,5005,5197,4483240,3262042,839226,632191,207035,381972,101,381871,107345,89549,17796,722,17074,41765,36427,22366
"Calcasieu, LA",2007,3928813,1090371,114411,8259,967701,1308127,187081,33821,21001,5828,612,44,5173,6992,4706934,3472500,849549,631277,218272,384885,-1111,385996,109153,91597,17556,815,16741,43122,37911,23057
"Calcasieu, LA",2008,4208833,1250304,139256,11102,1099946,1282061,188928,35681,22277,6618,737,59,5822,6786,5042614,3761103,901718,670138,231580,379793,-1108,380901,111404,92990,18414,806,17608,45264,40446,21632
"Calcasieu, LA",2009,4101474,1317865,142831,29397,1145637,1048818,191080,33851,21465,6897,747,154,5996,5489,4879936,3576006,906062,681608,224454,397868,1142,396726,108791,89772,19019,801,18218,44856,39834,21777
"Calcasieu, LA",2010,4201435,1417954,162191,36194,1219569,1028343,193036,34438,21765,7346,840,187,6318,5327,4962508,3520328,958765,735390,223375,483415,3113,480302,106982,87477,19505,790,18715,46386,40243,25664
"Calcasieu, LA",2011,4383465,1447295,168166,26489,1252640,1119319,193813,35860,22617,7467,868,137,6463,5775,5130085,3681600,928257,689233,239024,520228,3006,517222,108662,88128,20534,782,19752,47211,41776,26186
"Calcasieu, LA",2012,4634021,1496146,176120,19442,1300584,1233609,194506,37859,23825,7692,905,100,6687,6342,5402154,3862399,968597,720583,248014,571158,6753,564405,110879,89916,20963,769,20194,48721,42956,27949
"Calcasieu, LA",2013,4785229,1544937,172865,12493,1359579,1158500,195506,38304,24476,7902,884,64,6954,5926,5702460,3993338,1019105,759007,260098,690017,13537,676480,113515,91736,21779,753,21026,50235,43531,32173
"Calcasieu, LA",2014,5313247,1548143,171319,8573,1368251,1226106,196641,41128,27020,7873,871,44,6958,6235,6258510,4318354,1118987,837420,281567,821169,11164,810005,116398,94086,22312,751,21561,53768,45898,37568
"Calcasieu, LA",2015,5657412,1710427,169751,10315,1530361,1305715,198542,43686,28495,8615,855,52,7708,6577,6638934,4613121,1186544,883907,302637,839269,3938,835331,120570,97663,22907,744,22163,55063,47235,37690
"Calcasieu, LA",2016,5858677,1807217,179395,11149,1616673,1277788,200632,44578,29201,9008,894,56,8058,6369,6833615,4819057,1231784,918456,313328,782774,1791,780983,122738,100212,22526,743,21783,55676,48089,35853
"Calcasieu, LA",2017,6192557,1890392,166186,8959,1715247,1329013,202445,46491,30589,9338,821,44,8473,6565,7241909,5153194,1305881,972796,333085,782834,3076,779758,127360,104443,22917,731,22186,56862,49340,35146
"Calhoun, TX",2001,303096,84770,7730,2723,74317,70788,20762,22091,14599,4083,372,131,3579,3409,593022,434345,105447,75531,29916,53230,9642,43588,13368,10928,2440,338,2102,44361,39746,20736
"Calhoun, TX",2002,291366,91466,8699,3377,79390,66203,20550,21851,14178,4451,423,164,3863,3222,557919,406480,100345,73404,26941,51094,2864,48230,12417,9934,2483,329,2154,44932,40918,22391
"Calhoun, TX",2003,298148,94618,9783,2804,82031,68010,20575,22395,14491,4599,475,136,3987,3305,545821,389242,97555,70436,27119,59024,16273,42751,12153,9771,2382,299,2083,44912,39836,20524
"Calhoun, TX",2004,292104,102834,10282,1873,90679,57766,20692,21878,14117,4970,497,91,4382,2792,547894,407347,99951,71851,28100,40596,14301,26295,12078,9593,2485,281,2204,45363,42463,11931
"Calhoun, TX",2005,315553,112357,11845,1265,99247,60484,20715,23577,15233,5424,572,61,4791,2920,593164,442930,107924,77951,29973,42310,12568,29742,12438,9933,2505,269,2236,47690,44592,13301
"Calhoun, TX",2006,345655,118289,11901,999,105389,59960,20839,25141,16587,5676,571,48,5057,2877,621409,462352,109872,79080,30792,49185,8570,40615,12444,9971,2473,252,2221,49936,46370,18287
"Calhoun, TX",2007,382007,127987,12180,1025,114782,72810,20888,27901,18288,6127,583,49,5495,3486,679846,504561,115489,82520,32969,59796,1607,58189,12850,10251,2599,259,2340,52906,49221,24867
"Calhoun, TX",2008,425524,142101,13232,1569,127300,91303,21127,31189,20141,6726,626,74,6025,4322,716128,520081,118169,85765,32404,77878,-596,78474,12744,10234,2510,253,2257,56193,50819,34769
"Calhoun, TX",2009,364487,155550,15603,5442,134505,80215,21388,28065,17042,7273,730,254,6289,3750,625193,469518,114908,84287,30621,40767,-4516,45283,12346,9913,2433,247,2186,50639,47364,20715
"Calhoun, TX",2010,391209,168339,17932,6168,144239,78052,21311,29919,18357,7899,841,289,6768,3663,683241,506826,127123,91455,35668,49292,6849,42443,12503,10033,2470,243,2227,54646,50516,19058
"Calhoun, TX",2011,440423,176377,18072,5329,152976,93884,21356,33278,20623,8259,846,250,7163,4396,771837,558508,136295,96948,39347,77034,389,76645,13005,10540,2465,237,2228,59349,52989,34401
"Calhoun, TX",2012,472805,168938,17452,3978,147508,100921,21575,34422,21914,7830,809,184,6837,4678,796742,564458,137553,98096,39457,94731,-3685,98416,12752,10238,2514,232,2282,62480,55134,43127
"Calhoun, TX",2013,530833,175843,17402,2952,155489,106696,21735,37422,24423,8090,801,136,7154,4909,890750,605446,150631,108282,42349,134673,1778,132895,13236,10659,2577,237,2340,67298,56801,56793
"Calhoun, TX",2014,500372,188673,17389,1867,169417,114539,21805,36853,22948,8653,797,86,7770,5253,888417,650688,159938,115318,44620,77791,-7438,85229,13483,10890,2593,234,2359,65892,59751,36129
"Calhoun, TX",2015,495360,200302,17385,2606,180311,114183,21881,37011,22639,9154,795,119,8241,5218,927516,709669,174408,125076,49332,43439,-5469,48908,14104,11631,2473,237,2236,65763,61015,21873
"Calhoun, TX",2016,464674,211150,17766,3834,189550,110237,21942,35824,21177,9623,810,175,8639,5024,897977,704533,170608,121565,49043,22836,-8627,31463,13770,11387,2383,236,2147,65213,61872,14654
"Calhoun, TX",2017,463599,217734,21356,2553,193825,114204,21744,36587,21321,10014,982,117,8914,5252,889989,701817,170190,122940,47250,17982,-5855,23837,13467,11042,2425,235,2190,66087,63559,10884
"Chambers, TX",2001,554329,78289,7926,1565,68798,110029,26811,27699,20675,2920,296,58,2566,4104,363299,265991,64267,46475,17792,33041,10291,22750,9970,7524,2446,603,1843,36439,35352,12344
"Chambers, TX",2002,553165,84512,8720,2334,73458,104250,27490,26989,20122,3074,317,85,2672,3792,394015,289899,70713,51583,19130,33403,10125,23278,10419,8035,2384,592,1792,37817,36080,12990
"Chambers, TX",2003,577964,94722,10207,3365,81150,107057,28021,27827,20626,3380,364,120,2896,3821,456038,335523,81543,58843,22700,38972,15694,23278,10845,8428,2417,571,1846,42051,39811,12610
"Chambers, TX",2004,634783,105687,10957,2208,92522,110150,28749,29588,22080,3676,381,77,3218,3831,482211,355342,86562,62644,23918,40307,15822,24485,11541,9029,2512,554,1958,41782,39356,12505
"Chambers, TX",2005,673491,122988,14222,1938,106828,103244,29388,30615,22917,4185,484,66,3635,3513,521738,394665,91261,64496,26765,35812,8329,27483,12390,9745,2645,555,2090,42110,40499,13150
"Chambers, TX",2006,752497,128183,13719,1519,112945,105562,29980,32897,25100,4276,458,51,3767,3521,609205,469495,104403,73831,30572,35307,6567,28740,13908,11253,2655,541,2114,43802,41722,13595
"Chambers, TX",2007,816206,140586,12976,1565,126045,120257,30714,35067,26574,4577,422,51,4104,3915,643433,510177,109439,76656,32783,23817,560,23257,13878,11713,2165,576,1589,46364,43556,14636
"Chambers, TX",2008,896136,163708,12615,2791,148302,144249,31619,38081,28342,5178,399,88,4690,4562,659901,519407,112083,79703,32380,28411,-984,29395,15320,11974,3346,594,2752,43074,43378,10681
"Chambers, TX",2009,928404,183027,14601,9326,159100,153526,34230,36955,27123,5347,427,272,4648,4485,631109,486852,111900,80549,31351,32357,-6365,38722,14959,11205,3754,615,3139,42189,43450,12336
"Chambers, TX",2010,1032679,205678,17142,10971,177565,150528,35445,39184,29135,5803,484,310,5010,4247,674083,504656,117627,84122,33505,51800,-7100,58900,14853,11145,3708,639,3069,45384,45281,19192
"Chambers, TX",2011,1139757,216750,18114,8661,189975,162268,35683,42563,31941,6074,508,243,5324,4547,773419,574214,127139,87369,39770,72066,-1229,73295,16215,12217,3998,661,3337,47698,47001,21964
"Chambers, TX",2012,1229014,216459,18420,7319,190720,183797,36489,44651,33682,5932,505,201,5227,5037,911604,683349,147752,100422,47330,80503,276,80227,17717,13561,4156,673,3483,51454,50391,23034
"Chambers, TX",2013,1330168,219019,18715,5490,194814,186975,37350,46484,35614,5864,501,147,5216,5006,1008633,749030,165319,113636,51683,94284,7735,86549,18327,13932,4395,680,3715,55035,53763,23297
"Chambers, TX",2014,1432653,231374,18884,3399,209091,210506,38283,48965,37423,6044,493,89,5462,5499,954037,690292,154043,108328,45715,109702,8573,101129,17546,13102,4444,671,3773,54373,52686,26803
"Chambers, TX",2015,1523285,250898,18578,4491,227829,219243,39059,51036,39000,6424,476,115,5833,5613,1049528,780213,176257,124062,52195,93058,2153,90905,18894,14357,4537,664,3873,55548,54344,23471
"Chambers, TX",2016,1585457,265667,19094,5350,241223,221901,40283,51462,39358,6595,474,133,5988,5509,1106722,838279,185917,128469,57448,82526,2810,79716,19176,14484,4692,661,4031,57714,57876,19776
"Chambers, TX",2017,1636855,279296,23928,5026,250342,231830,41441,51832,39498,6740,577,121,6041,5594,1173473,900444,198905,138520,60385,74124,6122,68002,19599,14826,4773,657,4116,59874,60734,16521
"Charlotte, FL",2001,1616125,943242,25423,6672,911147,1316736,146311,26492,11046,6447,174,46,6227,9000,1624680,1103201,246037,169309,76728,275442,2306,273136,55287,42471,12816,266,12550,29386,25975,21764
"Charlotte, FL",2002,1738341,994772,29046,12132,953594,1187166,150123,26114,11579,6626,193,81,6352,7908,1704469,1141190,266280,186407,79873,296999,4823,292176,54855,41248,13607,252,13355,31072,27667,21878
"Charlotte, FL",2003,1858498,1045970,33625,11859,1000486,1195057,153235,26753,12128,6826,219,77,6529,7799,1779488,1192560,286414,203310,83104,300514,5298,295216,55225,41249,13976,230,13746,32223,28911,21477
"Charlotte, FL",2004,1966080,1168307,74153,9112,1085042,1356452,157755,28467,12463,7406,470,58,6878,8598,1912126,1320675,314748,221373,93375,276703,6061,270642,57451,42834,14617,209,14408,33283,30832,18784
"Charlotte, FL",2005,2184238,1156936,44384,4863,1107689,1446410,155262,30836,14068,7452,286,31,7134,9316,2075407,1459269,344366,241442,102924,271772,14006,257766,59929,44433,15496,193,15303,34631,32842,16844
"Charlotte, FL",2006,2357024,1253105,44554,5237,1203314,1567865,157099,32960,15003,7977,284,33,7660,9980,2250039,1625603,361819,244721,117098,262617,16536,246081,64678,48886,15792,174,15618,34788,33253,15756
"Charlotte, FL",2007,2308615,1335438,47738,12345,1275355,1747074,159742,33749,14452,8360,299,77,7984,10937,2195419,1604860,365778,251830,113948,224781,11027,213754,64346,47494,16852,190,16662,34119,33791,12829
"Charlotte, FL",2008,2112061,1497387,55800,23526,1418061,1727706,160467,33260,13162,9331,348,147,8837,10767,2087293,1547374,364544,254350,110194,175375,12848,162527,61774,45085,16689,195,16494,33789,34321,9854
"Charlotte, FL",2009,1971747,1633113,70789,50837,1511487,1415222,159629,31448,12352,10231,443,318,9469,8866,1977790,1448619,344439,239425,105014,184732,21358,163374,59476,42616,16860,202,16658,33254,33992,9808
"Charlotte, FL",2010,1982574,1751014,83290,51036,1616688,1395974,159869,32086,12401,10953,521,319,10113,8732,2067459,1459959,364745,256985,107760,242755,32336,210419,59627,42986,16641,209,16432,34673,33964,12805
"Charlotte, FL",2011,2020550,1805072,89837,29717,1685518,1532701,159881,33514,12638,11290,562,186,10542,9587,2128854,1503032,351580,238637,112943,274242,33952,240290,60926,43616,17310,215,17095,34942,34461,14056
"Charlotte, FL",2012,2130377,1853958,89853,19137,1744968,1567478,162833,34095,13083,11386,552,118,10716,9626,2247595,1553585,359824,240880,118944,334186,52616,281570,61871,44420,17451,220,17231,36327,34975,16341
"Charlotte, FL",2013,2183818,1919619,90879,12542,1816198,1627950,164830,34772,13249,11646,551,76,11019,9877,2319092,1636828,384761,262051,122710,297503,47557,249946,63458,45484,17974,223,17751,36545,35987,14081
"Charlotte, FL",2014,2288718,2056534,88992,6300,1961242,1844177,168336,36768,13596,12217,529,37,11651,10955,2406055,1692697,386362,260666,125696,326996,44843,282153,65561,46535,19026,223,18803,36699,36375,15006
"Charlotte, FL",2015,2484856,2197218,89128,3530,2104560,1972869,172824,38507,14378,12714,516,20,12177,11415,2589531,1806057,407667,278348,129319,375807,56678,319129,68115,48084,20031,225,19806,38017,37560,16113
"Charlotte, FL",2016,2620065,2302371,84914,2865,2214592,2124313,178157,39554,14706,12923,477,16,12431,11924,2703691,1904423,413866,280103,133763,385402,41425,343977,69745,49724,20021,224,19797,38765,38300,17375
"Charlotte, FL",2017,2740569,2415036,93505,2715,2318816,2227048,182033,40557,15055,13267,514,15,12738,12234,2817073,1987291,425581,287250,138331,404201,44624,359577,70542,50113,20429,223,20206,39935,39656,17796
"Dallas, TX",2001,60490382,6445983,669555,258182,5518246,12812790,2249418,35453,26892,2866,298,115,2453,5696,98441052,72582737,13008338,8149509,4858829,12849977,7961,12842016,1867102,1624532,242570,766,241804,52724,44679,53109
"Dallas, TX",2002,60107003,7125132,822588,477759,5824785,12123357,2250326,35264,26710,3166,366,212,2588,5387,97000883,70038837,13137530,8419838,4717692,13824516,9265,13815251,1808086,1557365,250721,697,250024,53648,44973,55256
"Dallas, TX",2003,58884606,7471721,952989,346299,6172433,12988462,2246432,35320,26213,3326,424,154,2748,5782,95635208,69093228,13506000,8587457,4918543,13035980,7811,13028169,1771561,1504787,266774,676,266098,53984,45916,48960
"Dallas, TX",2004,58926678,7732623,1056668,211256,6464699,13444891,2244020,35697,26259,3446,471,94,2881,5991,97526140,72013098,13839578,8727532,5112046,11673464,7965,11665499,1778450,1500470,277980,655,277325,54838,47994,42064
"Dallas, TX",2005,60893999,8513142,1239993,147954,7125195,16207389,2250830,38037,27054,3782,551,66,3166,7201,101660338,74434162,14374515,9140805,5233710,12851661,11506,12840155,1790876,1497874,293002,652,292350,56766,49693,43920
"Dallas, TX",2006,66087452,9012032,1284363,127391,7600278,18238823,2275434,41020,29044,3961,564,56,3340,8016,110186197,79988648,14978653,9602176,5376477,15218896,13646,15205250,1841724,1534532,307192,634,306558,59828,52126,49600
"Dallas, TX",2007,66540173,9839285,1341255,128780,8369250,20777772,2291891,42392,29033,4293,585,56,3652,9066,113626635,85127853,15382338,9799565,5582773,13116444,11255,13105189,1887372,1557673,329699,671,329028,60204,54651,39830
"Dallas, TX",2008,68132034,11290328,1525438,212210,9552680,23472546,2314018,44466,29443,4879,659,92,4128,10144,116920846,87070999,15452656,9803620,5649036,14397191,13175,14384016,1912563,1569855,342708,684,342024,61133,55464,42056
"Dallas, TX",2009,61064442,12430486,1835264,636552,9958670,18235345,2346378,39094,26025,5298,782,271,4244,7772,107505848,82108014,15520651,10024349,5496302,9877183,12941,9864242,1853912,1495063,358849,696,358153,57989,54919,27542
"Dallas, TX",2010,64595044,13743856,2124339,704188,10915329,18577059,2372257,40854,27229,5794,895,297,4601,7831,112233908,83634509,15899238,10174562,5724676,12700161,7955,12692206,1855527,1488065,367462,711,366751,60486,56204,34607
"Dallas, TX",2011,75687509,14123325,2244024,551629,11327672,24730714,2408133,47564,31430,5865,932,229,4704,10270,124393920,87646623,16192749,10178089,6014660,20554548,6421,20548127,1913241,1513820,399421,725,398696,65017,57898,51538
"Dallas, TX",2012,80527527,14054195,2319325,466504,11268366,24772419,2454781,48621,32804,5725,945,190,4590,10091,131132172,92584954,16962079,10644552,6317527,21585139,12123,21573016,1963201,1552693,410508,734,409774,66795,59629,52646
"Dallas, TX",2013,83564657,14470590,2358038,361275,11751277,23685307,2483807,49006,33644,5826,949,145,4731,9536,137097355,95703271,18059261,11509051,6550210,23334823,21016,23313807,2007569,1583403,424166,741,423425,68290,60442,55060
"Dallas, TX",2014,89092488,15213533,2401091,232505,12579937,26597932,2517417,51999,35390,6043,954,92,4997,10566,145982536,102423124,19035289,12129950,6905339,24524123,10231,24513892,2077712,1641066,436646,732,435914,70261,62413,56236
"Dallas, TX",2015,90199825,16085457,2371619,258283,13455555,28075436,2554233,52603,35314,6298,929,101,5268,10992,151051205,109470105,20510296,13129209,7381087,21070804,17572,21053232,2157608,1706073,451535,727,450808,70009,64165,46701
"Dallas, TX",2016,91420785,16799860,2342675,259327,14197858,32681026,2587462,54456,35332,6493,905,100,5487,12631,156138695,114399860,21003709,13268153,7735556,20735126,8992,20726134,2222042,1754996,467046,724,466322,70268,65185,44446
"Dallas, TX",2017,94830725,17102522,2324738,221011,14556773,34314732,2618148,55859,36221,6532,888,84,5560,13106,162955666,119808014,22181393,14027868,8153525,20966259,8699,20957560,2268710,1789988,478722,719,478003,71827,66932,43844
"Escambia, FL",2001,4547110,1253502,132510,18178,1102814,1778481,297776,25452,15270,4210,445,61,3704,5973,5842352,4372123,1052139,743887,308252,418090,4658,413432,167687,144896,22791,679,22112,34841,30174,18697
"Escambia, FL",2002,4652624,1363352,143606,25845,1193901,1753937,297568,26111,15635,4582,483,87,4012,5894,5970447,4400584,1123226,807107,316119,446637,2405,444232,165260,141956,23304,640,22664,36128,31000,19601
"Escambia, FL",2003,4859918,1467963,158085,24896,1284982,1765038,296603,27285,16385,4949,533,84,4332,5951,6240920,4561783,1226305,896740,329565,452832,5514,447318,167001,143390,23611,628,22983,37371,31814,19463
"Escambia, FL",2004,5113912,1592075,208783,17167,1366125,1775527,298225,28440,17148,5339,700,58,4581,5954,6607553,4874262,1293998,938066,355932,439293,3723,435570,171275,147002,24273,603,23670,38579,33158,18402
"Escambia, FL",2005,5399671,1640904,197995,10772,1432137,1845853,298339,29786,18099,5500,664,36,4800,6187,6957198,5119555,1351701,980023,371678,485942,4409,481533,172394,146989,25405,590,24815,40356,34830,19405
"Escambia, FL",2006,5722396,1740643,195026,9374,1536243,2067391,300395,31726,19050,5795,649,31,5114,6882,7384481,5471492,1377329,969025,408304,535660,7393,528267,176678,150413,26265,567,25698,41796,36376,20557
"Escambia, FL",2007,5785186,1859415,198437,13418,1647560,2193170,297393,33080,19453,6252,667,45,5540,7375,7595115,5670146,1435818,1019681,416137,489151,2625,486526,178616,150890,27726,658,27068,42522,37578,17974
"Escambia, FL",2008,5691299,2106574,221211,25453,1859910,2184115,296854,33626,19172,7096,745,86,6265,7358,7600364,5702100,1489673,1068221,421452,408591,676,407915,174368,147254,27114,652,26462,43588,38723,15415
"Escambia, FL",2009,5524432,2289279,257429,69424,1962426,2015181,297015,33092,18600,7708,867,234,6607,6785,7461533,5589969,1473679,1051737,421942,397885,-4833,402718,167009,139558,27451,654,26797,44677,40055,15028
"Escambia, FL",2010,5691339,2502665,287184,74472,2141009,2061408,298036,34410,19096,8397,964,250,7184,6917,7689695,5640743,1576382,1140983,435399,472570,-2003,474573,167126,139231,27895,657,27238,46011,40514,17423
"Escambia, FL",2011,5931517,2599012,294896,56985,2247131,2204475,299366,35859,19814,8682,985,190,7506,7364,7858787,5795149,1556315,1099609,456706,507323,6184,501139,167958,139233,28725,662,28063,46790,41622,17858
"Escambia, FL",2012,6106004,2560677,296598,38368,2225711,2354177,303467,36316,20121,8438,977,126,7334,7758,8060165,5895771,1591483,1116576,474907,572911,-1015,573926,167753,139160,28593,657,27936,48048,42367,20544
"Escambia, FL",2013,6086946,2623623,306916,28288,2288419,2308023,306767,35918,19842,8552,1000,92,7460,7524,8195083,6028387,1651729,1172838,478891,514967,3802,511165,171517,142577,28940,663,28277,47780,42282,18077
"Escambia, FL",2014,6265658,2780514,303252,14174,2463088,2480595,308103,37412,20336,9025,984,46,7994,8051,8416128,6228313,1637864,1151779,486085,549951,-4920,554871,174216,143876,30340,661,29679,48309,43289,18696
"Escambia, FL",2015,6576761,2900850,300310,8174,2592366,2663986,309529,39226,21248,9372,970,26,8375,8607,8776827,6524449,1696129,1198034,498095,556249,-2559,558808,176343,145734,30609,658,29951,49771,44770,18657
"Escambia, FL",2016,6643586,3009592,284545,6217,2718830,2737026,311711,39749,21313,9655,913,20,8722,8781,9024358,6776046,1699275,1194809,504466,549037,-4996,554033,181232,149321,31911,655,31256,49795,45379,17726
"Escambia, FL",2017,6831732,3146963,297664,5624,2843675,2829753,313512,40855,21791,10038,949,18,9070,9026,9382667,7076998,1736563,1217407,519156,569106,-2146,571252,184750,152274,32476,653,31823,50786,46475,17951
"Franklin, FL",2001,120908,49843,4270,546,45027,65650,9910,23855,12201,5030,431,55,4544,6625,130889,71721,18475,13433,5042,40693,0,40693,5002,3245,1757,0,1757,26167,22102,23161
"Franklin, FL",2002,132249,52617,4491,896,47230,64578,9972,25014,13262,5276,450,90,4736,6476,142229,79234,20970,15425,5545,42025,0,42025,5248,3451,1797,0,1797,27102,22960,23386
"Franklin, FL",2003,142981,54538,5010,824,48704,64282,10025,26115,14262,5440,500,82,4858,6412,151449,83694,22173,16368,5805,45582,0,45582,5188,3479,1709,0,1709,29192,24057,26672
"Franklin, FL",2004,154922,60184,5775,381,54028,71165,10090,28372,15354,5965,572,38,5355,7053,161343,89770,23928,17627,6301,47645,0,47645,5228,3479,1749,0,1749,30861,25803,27241
"Franklin, FL",2005,158520,59384,6662,498,52224,81771,10198,29386,15544,5823,653,49,5121,8018,161909,95000,25309,18718,6591,41600,0,41600,5214,3458,1756,0,1756,31053,27473,23690
"Franklin, FL",2006,166091,63783,6607,317,56859,94158,11308,28655,14688,5641,584,28,5028,8327,167609,105607,27971,20588,7383,34031,0,34031,5438,3639,1799,0,1799,30822,29021,18917
"Franklin, FL",2007,163680,65637,6736,299,58602,105331,11491,29123,14244,5712,586,26,5100,9166,163039,110130,29702,22090,7612,23207,0,23207,5547,3710,1837,0,1837,29392,29685,12633
"Franklin, FL",2008,153702,74582,6986,480,67116,102412,11484,28796,13384,6494,608,42,5844,8918,149865,106805,29299,21897,7402,13761,0,13761,5211,3465,1746,0,1746,28759,30824,7881
"Franklin, FL",2009,150479,77818,8471,1370,67977,82605,11515,27000,13068,6758,736,119,5903,7174,152591,105268,29290,21843,7447,18033,0,18033,5224,3391,1833,0,1833,29210,31043,9838
"Franklin, FL",2010,157181,90754,9947,1778,79029,83940,11522,28804,13642,7877,863,154,6859,7285,165643,106740,31356,23675,7681,27547,0,27547,5470,3476,1994,0,1994,30282,30708,13815
"Franklin, FL",2011,163183,93336,9767,1542,82027,91215,11469,30319,14228,8138,852,134,7152,7953,175044,107428,30119,22289,7830,37497,0,37497,5513,3566,1947,0,1947,31751,30126,19259
"Franklin, FL",2012,168468,94118,10302,1075,82741,99791,11608,31218,14513,8108,887,93,7128,8597,186857,109936,30875,22653,8222,46046,0,46046,5375,3596,1779,0,1779,34764,30572,25883
"Franklin, FL",2013,157159,95458,10481,618,84359,103310,11519,30899,13643,8287,910,54,7323,8969,182198,114107,32215,23835,8380,35876,0,35876,5430,3632,1798,0,1798,33554,31417,19953
"Franklin, FL",2014,153440,100559,10663,521,89375,111579,11644,31396,13178,8636,916,45,7676,9583,177695,115142,32125,23716,8409,30428,0,30428,5415,3620,1795,0,1795,32815,31807,16952
"Franklin, FL",2015,152474,105640,10215,167,95258,126227,11684,32895,13050,9041,874,14,8153,10803,176540,116513,31694,23365,8329,28333,0,28333,5328,3583,1745,0,1745,33134,32518,16237
"Franklin, FL",2016,153053,110502,10051,155,100296,125357,11799,32961,12972,9365,852,13,8500,10624,177335,116955,30975,22759,8216,29405,0,29405,5369,3574,1795,0,1795,33029,32724,16382
"Franklin, FL",2017,157376,114897,9864,126,104907,131687,11727,34447,13420,9798,841,11,8946,11229,182559,120507,31355,22960,8395,30697,0,30697,5444,3628,1816,0,1816,33534,33216,16904
"Galveston, TX",2001,5766873,926564,80052,22427,824085,1128641,254521,30733,22658,3640,315,88,3238,4434,4090784,2845133,724992,545995,178997,520659,-155,520814,117109,92616,24493,680,23813,34931,30720,21871
"Galveston, TX",2002,5925284,1025558,89940,39821,895797,1109381,260096,30989,22781,3943,346,153,3444,4265,4247699,2943132,749754,564692,185062,554813,876,553937,118839,93373,25466,651,24815,35743,31520,22323
"Galveston, TX",2003,6061672,1098307,105503,39214,953590,1209018,265269,31549,22851,4140,398,148,3595,4558,4395110,3071065,824002,622457,201545,500043,2609,497434,121123,93978,27145,630,26515,36286,32679,18760
"Galveston, TX",2004,6229235,1151095,114355,26152,1010588,1217511,269760,31872,23092,4267,424,97,3746,4513,4471886,3179090,845246,638504,206742,447550,2557,444993,122085,94263,27822,609,27213,36629,33726,16352
"Galveston, TX",2005,6555157,1283614,136516,18217,1128881,1348250,274806,33431,23854,4671,497,66,4108,4906,4605638,3305552,870110,657779,212331,429976,2339,427637,123741,94066,29675,609,29066,37220,35141,14713
"Galveston, TX",2006,7298608,1353600,135315,15378,1202907,1478334,279182,36287,26143,4848,485,55,4309,5295,5265951,3779886,990786,754818,235968,495279,1772,493507,129618,98481,31137,592,30545,40627,38382,16157
"Galveston, TX",2007,7920690,1468091,136019,15782,1316290,1627497,283770,38821,27912,5174,479,56,4639,5735,5668477,4174770,1017354,759078,258276,476353,502,475851,133579,102337,31242,629,30613,42435,40794,15544
"Galveston, TX",2008,8006319,1653921,153602,27961,1472358,1866683,288643,39935,27738,5730,532,97,5101,6467,5905101,4373476,1047185,778083,269102,484440,-568,485008,135788,102894,32894,611,32283,43488,42505,15024
"Galveston, TX",2009,7986548,1762175,169786,78238,1514151,1820370,287428,40250,27786,6131,591,272,5268,6333,5831424,4263697,1065493,795979,269514,502234,-492,502726,133780,98945,34835,596,34239,43590,43092,14683
"Galveston, TX",2010,8188270,1984190,193695,92513,1697982,1735422,292470,40715,27997,6784,662,316,5806,5934,6084125,4317485,1139014,852244,286770,627626,-1885,629511,135810,100841,34969,584,34385,44799,42815,18308
"Galveston, TX",2011,8717423,2045851,199266,75804,1770781,1997753,295609,43169,29490,6921,674,256,5990,6758,6281958,4431123,1124962,834088,290874,725873,-2400,728273,139247,102501,36746,572,36174,45114,43230,20132
"Galveston, TX",2012,9268128,2070111,201710,63053,1805348,2261036,301059,45171,30785,6876,670,209,5997,7510,6534581,4553465,1173443,873900,299543,807673,-1696,809369,141618,104186,37432,551,36881,46142,43705,21945
"Galveston, TX",2013,9659719,2149275,205969,46096,1897210,2166681,306662,45574,31500,7009,672,150,6187,7065,6747626,4636254,1265576,961546,304030,845796,-1697,847493,144988,105882,39106,556,38550,46539,43787,21984
"Galveston, TX",2014,10379525,2316229,212420,30498,2073311,2378960,313609,48068,33097,7386,677,97,6611,7586,7226039,4933278,1328441,1003170,325271,964320,-2636,966956,149462,109349,40113,550,39563,48347,45115,24441
"Galveston, TX",2015,11068134,2490278,210806,37888,2241584,2511808,321305,50015,34447,7751,656,118,6976,7818,7643542,5098805,1394248,1060573,333675,1150489,-1441,1151930,152742,111107,41635,544,41091,50042,45891,28034
"Galveston, TX",2016,10949995,2636695,216494,42118,2378083,2394283,329306,48529,33252,8007,657,128,7221,7271,7665096,5435594,1456538,1101435,355103,772964,-2858,775822,155163,115937,39226,542,38684,49400,46884,20055
"Galveston, TX",2017,11198493,2728113,245760,35657,2446696,2516767,335036,49079,33425,8143,734,106,7303,7512,7911041,5662928,1512587,1141225,371362,735526,-2441,737967,158143,118156,39987,539,39448,50025,47928,18707
"Hancock, MS",2001,587928,194331,15046,2132,177153,211996,44172,22509,13310,4399,341,48,4011,4799,648143,477878,111171,75741,35430,59094,1180,57914,19251,15068,4183,308,3875,33668,31715,14946
"Hancock, MS",2002,611983,207125,15804,3296,188025,201581,45058,22653,13582,4597,351,73,4173,4474,687668,505650,119769,81124,38645,62249,759,61490,19660,15363,4297,268,4029,34978,32913,15262
"Hancock, MS",2003,639917,219177,17662,3294,198221,199066,45772,23118,13981,4788,386,72,4331,4349,717084,527512,125845,85506,40339,63727,576,63151,19560,15086,4474,265,4209,36661,34967,15004
"Hancock, MS",2004,669102,240253,19273,2356,218624,216522,46717,24100,14322,5143,413,50,4680,4635,753046,549784,136752,93968,42784,66510,910,65600,19841,15318,4523,253,4270,37954,35891,15363
"Hancock, MS",2005,647897,437387,109584,5008,322795,187517,47715,26675,13578,9167,2297,105,6765,3930,784651,574588,146015,102422,43593,64048,251,63797,18149,14516,3633,252,3381,43234,39583,18869
"Hancock, MS",2006,680300,268502,17155,3734,247613,227388,40087,29341,16971,6698,428,93,6177,5672,828644,591815,147050,101845,45205,89779,1378,88401,17867,13418,4449,244,4205,46378,44106,21023
"Hancock, MS",2007,708192,234494,20031,1895,212568,751361,41707,40618,16980,5622,480,45,5097,18015,888138,657106,160351,110302,50049,70681,-960,71641,20081,15291,4790,240,4550,44228,42973,15745
"Hancock, MS",2008,758642,272765,21191,2851,248723,392406,42764,33295,17740,6378,496,67,5816,9176,940266,697596,169578,117534,52044,73092,-2115,75207,20552,15734,4818,234,4584,45751,44337,16406
"Hancock, MS",2009,737184,293615,27327,7300,258988,380112,43471,32456,16958,6754,629,168,5958,8744,942179,718398,180026,124782,55244,43755,-1495,45250,20338,15734,4604,229,4375,46326,45659,10343
"Hancock, MS",2010,788657,325564,32435,7963,285166,359777,44075,33443,17894,7387,736,181,6470,8163,999870,731521,182702,126556,56146,85647,-1873,87520,20380,15646,4734,225,4509,49061,46755,19410
"Hancock, MS",2011,815097,345093,33737,6959,304397,275075,44707,32104,18232,7719,755,156,6809,6153,1006442,727311,184017,125788,58229,95114,-1439,96553,19902,15376,4526,221,4305,50570,47302,22428
"Hancock, MS",2012,844390,341910,35731,5536,300643,294087,45231,32729,18668,7559,790,122,6647,6502,1023503,742210,189740,129631,60109,91553,-1251,92804,20113,15409,4704,213,4491,50888,48167,20664
"Hancock, MS",2013,828272,354430,36638,4490,313302,297774,45489,32546,18208,7792,805,99,6887,6546,990139,727812,187585,129057,58528,74742,-146,74888,20166,15300,4866,210,4656,49099,47569,16084
"Hancock, MS",2014,852077,389437,37498,2309,349630,314815,45939,33878,18548,8477,816,50,7611,6853,1005911,738942,195164,135565,59599,71805,-811,72616,20104,15193,4911,209,4702,50035,48637,15444
"Hancock, MS",2015,796508,396056,37322,1886,356848,329879,46255,32914,17220,8562,807,41,7715,7132,974056,748154,195261,134917,60344,30641,-499,31140,20157,15250,4907,209,4698,48323,49059,6628
"Hancock, MS",2016,800439,411850,36119,1958,373773,351832,46647,33531,17159,8829,774,42,8013,7542,970997,744275,199276,139416,59860,27446,-616,28062,20112,15018,5094,206,4888,48279,49559,5741
"Hancock, MS",2017,841021,417516,34806,1700,381010,368572,47053,34580,17874,8873,740,36,8097,7833,1016249,759504,204393,143101,61292,52352,-1017,53369,20239,15062,5177,203,4974,50212,50425,10730
"Harris, TX",2001,94676358,10043459,1322746,258178,8462535,17126362,3471291,35101,27274,2893,381,74,2438,4934,122902731,85266808,16151292,10590546,5560746,21484631,12759,21471872,2324036,1970154,353882,2413,351469,52883,43279,61092
"Harris, TX",2002,91907847,11079678,1348223,511485,9219970,16769356,3536682,33861,25987,3133,381,145,2607,4742,120188635,84634460,16480723,10865448,5615275,19073452,18877,19054575,2331937,1961589,370348,2354,367994,51540,43146,51780
"Harris, TX",2003,95133542,11739812,1561288,496059,9682465,18019895,3586133,34827,26528,3274,435,138,2700,5025,124190241,84866582,17387448,11434597,5952851,21936211,19286,21916925,2333205,1936122,397083,2191,394892,53227,43833,55501
"Harris, TX",2004,103704262,12309807,1743284,314642,10251881,19016529,3630185,37197,28567,3391,480,87,2824,5238,135024460,89593324,17963410,11764887,6198523,27467726,18079,27449647,2363204,1945438,417766,2064,415702,57136,46053,66032
"Harris, TX",2005,110339011,13803376,2135227,237493,11430656,23147561,3681829,40005,29969,3749,580,65,3105,6287,144227495,96195472,18934584,12415388,6519196,29097439,20021,29077418,2420600,1973416,447184,1997,445187,59583,48746,65315
"Harris, TX",2006,122507105,14622086,2152393,205316,12264377,27069789,3807435,43126,32176,3840,565,54,3221,7110,160581939,106313326,20623583,13692868,6930715,33645030,22151,33622879,2514387,2043400,470987,1888,469099,63865,52028,71675
"Harris, TX",2007,127512931,15981261,2177281,199816,13604164,28689580,3863344,44569,33006,4137,564,52,3521,7426,170581657,118539652,21616108,14146439,7469669,30425897,15518,30410379,2603161,2125436,477725,1950,475775,65529,55772,63918
"Harris, TX",2008,138604422,18354629,2442299,317944,15594386,34723333,3938580,48668,35191,4660,620,81,3959,8816,185036695,126007637,22384129,14622651,7761478,36644929,10141,36634788,2693786,2180558,513228,1943,511285,68690,57787,71652
"Harris, TX",2009,126997405,20227111,2836666,1005637,16384808,30068531,4034866,43940,31475,5013,703,249,4061,7452,172741030,120985102,22990532,15302458,7688074,28765396,8815,28756581,2664300,2120870,543430,1940,541490,64835,57045,53106
"Harris, TX",2010,135211278,22915565,3316619,1185812,18413134,29942566,4107854,45783,32915,5578,807,289,4482,7289,182350140,123795135,23596352,15666698,7929654,34958653,6974,34951679,2659686,2104121,555565,1950,553615,68561,58835,63134
"Harris, TX",2011,149282176,23880393,3509518,941290,19429585,31624405,4180816,48983,35706,5712,839,225,4647,7564,198516022,133040769,24339157,15699399,8639758,41136096,4529,41131567,2744613,2155043,589570,1954,587616,72329,61735,69997
"Harris, TX",2012,162951709,23627904,3568119,776852,19282933,39762014,4262689,53098,38227,5543,837,182,4524,9328,216379770,144059780,26211616,16927890,9283726,46108374,8789,46099585,2841362,2237580,603782,1938,601844,76154,64382,76597
"Harris, TX",2013,161893280,24388879,3632186,586150,20170543,38637474,4353517,51664,37187,5602,834,135,4633,8875,220580845,150563074,28405923,18617382,9788541,41611848,16033,41595815,2936417,2313668,622749,1950,620799,75119,65075,67004
"Harris, TX",2014,174805487,25765639,3714763,381835,21669041,42653744,4452695,54624,39258,5787,834,86,4867,9579,238379496,162877964,29892746,19515714,10377032,45608786,10012,45598774,3042968,2399374,643594,1927,641667,78338,67884,71063
"Harris, TX",2015,171390492,27537741,3723887,503391,23310463,47298463,4551362,54100,37657,6050,818,111,5122,10392,237375944,167546472,31493130,20788718,10704412,38336342,18310,38318032,3103525,2435451,668074,1896,666178,76486,68795,57519
"Harris, TX",2016,166560443,29146469,3846359,590112,24709998,40622621,4617041,51186,36075,6313,833,128,5352,8798,232542856,162921160,30904442,20278364,10626078,38717254,7638,38709616,3075014,2413525,661489,1890,659599,75623,67503,58687
"Harris, TX",2017,175002363,30032831,4285794,481805,25265232,42446924,4652980,53188,37611,6455,921,104,5430,9123,242312135,165462084,31860846,20884798,10976048,44989205,6547,44982658,3096828,2420341,676487,1877,674610,78245,68363,66680
"Humphreys, MS",2001,120867,61589,13603,1155,46831,38933,10969,20183,11019,5615,1240,105,4269,3549,133033,74823,17513,11788,5725,40697,24697,16000,4863,3986,877,290,587,27356,18771,27257
"Humphreys, MS",2002,85792,64376,14375,1397,48604,37799,10582,17763,8107,6084,1358,132,4593,3572,98325,76284,18636,12723,5913,3405,-13706,17111,4748,3907,841,269,572,20709,19525,29914
"Humphreys, MS",2003,115103,66457,14580,1248,50629,35679,10351,20987,11120,6420,1409,121,4891,3447,125992,73112,18820,13137,5683,34060,17822,16238,4449,3682,767,230,537,28319,19857,30238
"Humphreys, MS",2004,133847,71287,14992,881,55414,31193,10204,23160,13117,6986,1469,86,5431,3057,142639,74203,20200,14402,5798,48236,34755,13481,4321,3560,761,207,554,33011,20844,24334
"Humphreys, MS",2005,121234,72678,15458,985,56235,28197,9974,22269,12155,7287,1550,99,5638,2827,128570,75135,20366,14746,5620,33069,23535,9534,4196,3468,728,186,542,30641,21665,17590
"Humphreys, MS",2006,112995,76108,15952,825,59331,26682,9840,21929,11483,7735,1621,84,6030,2712,118460,76851,20481,14598,5883,21128,13045,8083,4194,3504,690,165,525,28245,21932,15396
"Humphreys, MS",2007,122270,80323,16641,768,62914,28890,9666,23948,12649,8310,1722,79,6509,2989,128389,82816,22418,15900,6518,23155,18391,4764,4350,3608,742,145,597,29515,22953,7980
"Humphreys, MS",2008,94393,88324,18478,1172,68674,35447,9691,22512,9740,9114,1907,121,7086,3658,102636,86419,22736,15671,7065,-6519,-11025,4506,4473,3603,870,161,709,22946,23985,6355
"Humphreys, MS",2009,92120,92009,20452,2653,68904,37331,9517,23270,9680,9668,2149,279,7240,3923,101657,84888,22495,15597,6898,-5726,-14122,8396,4481,3549,932,173,759,22686,23919,11062
"Humphreys, MS",2010,124535,97612,21636,2796,73180,32750,9335,27306,13341,10457,2318,300,7839,3508,136059,86848,22999,16121,6878,26212,10779,15433,4580,3591,989,185,804,29707,24185,19195
"Humphreys, MS",2011,138896,101342,22285,2359,76698,37964,9316,29863,14909,10878,2392,253,8233,4075,145640,80544,20991,14034,6957,44105,26768,17337,4415,3352,1063,197,866,32988,24029,20020
"Humphreys, MS",2012,107689,99699,22271,2096,75332,41964,9213,27065,11689,10822,2417,228,8177,4555,109819,74770,19583,13258,6325,15466,-1061,16527,3825,2686,1139,209,930,28711,27837,17771
"Humphreys, MS",2013,137790,99808,22491,1604,75713,38309,8963,30783,15373,11136,2509,179,8447,4274,143941,72903,19941,13554,6387,51097,33471,17626,3812,2682,1130,211,919,37760,27182,19180
"Humphreys, MS",2014,87101,102773,22065,763,79945,44599,8790,26675,9909,11692,2510,87,9095,5074,92093,73628,20839,14535,6304,-2374,-22104,19730,3912,2752,1160,210,950,23541,26754,20768
"Humphreys, MS",2015,85498,105360,22319,504,82537,44266,8703,27016,9824,12106,2565,58,9484,5086,90028,74260,19649,13391,6258,-3881,-21490,17609,3826,2650,1176,217,959,23531,28023,18362
"Humphreys, MS",2016,89150,108736,21375,476,86885,44466,8594,28200,10374,12653,2487,55,10110,5174,92455,70845,19270,13660,5610,2340,-14098,16438,3684,2538,1146,214,932,25096,27914,17637
"Humphreys, MS",2017,77183,108415,20728,358,87329,46103,8342,27775,9252,12996,2485,43,10469,5527,81384,72364,19716,13950,5766,-10696,-26232,15536,3745,2588,1157,211,946,21731,27961,16423
"Jackson, MS",2001,2088937,509325,46674,8918,453733,587041,133069,23937,15698,3828,351,67,3410,4412,2308170,1710485,448208,317789,130419,149477,2982,146495,64255,54742,9513,547,8966,35922,31246,16339
"Jackson, MS",2002,2070163,550379,53115,12676,484588,577191,133688,23919,15485,4117,397,95,3625,4317,2238000,1636767,442323,315739,126584,158910,2238,156672,63881,53795,10086,496,9590,35034,30426,16337
"Jackson, MS",2003,2203009,586700,57388,11961,517351,569470,134234,25025,16412,4371,428,89,3854,4242,2392783,1728865,490717,357933,132784,173201,2103,171098,63750,53600,10150,483,9667,37534,32255,17699
"Jackson, MS",2004,2345133,648755,60332,7981,580442,521216,136565,25739,17172,4751,442,58,4250,3817,2561729,1798142,565532,425491,140041,198055,1395,196660,63518,53532,9986,449,9537,40331,33590,20621
"Jackson, MS",2005,2499251,930063,187479,13769,728815,506708,137913,28540,18122,6744,1359,100,5285,3674,2677484,1933696,566593,420934,145659,177195,1210,175985,63173,53606,9567,438,9129,42383,36072,19278
"Jackson, MS",2006,2548431,763047,64316,9776,688955,563418,132717,29197,19202,5749,485,74,5191,4245,2789310,2013224,566631,410456,156175,209455,-508,209963,64323,53303,11020,415,10605,43364,37769,19798
"Jackson, MS",2007,2787547,746480,71990,6532,667958,1228520,136028,35012,20492,5488,529,48,4910,9031,3022030,2215777,602789,437817,164972,203464,-2586,206050,66425,54484,11941,400,11541,45495,40668,17854
"Jackson, MS",2008,2995482,853905,73554,9872,770479,839052,137791,34026,21739,6197,534,72,5592,6089,3385795,2518908,668124,485098,183026,198763,-4093,202856,68406,56867,11539,387,11152,49496,44295,18190
"Jackson, MS",2009,2929398,912720,89231,25392,798097,831637,139176,33582,21048,6558,641,182,5734,5975,3378675,2508547,692141,513922,178219,177987,-4744,182731,67086,55557,11529,381,11148,50363,45153,16391
"Jackson, MS",2010,2968595,997815,100752,28200,868863,806109,139454,34223,21287,7155,722,202,6230,5780,3486066,2566891,702395,518451,183944,216780,-7359,224139,68682,56604,12078,375,11703,50757,45348,19152
"Jackson, MS",2011,2962702,1035820,106969,24947,903904,885970,139936,34905,21172,7402,764,178,6459,6331,3306590,2444123,633765,454704,179061,228702,-5961,234663,65271,52898,12373,367,12006,50659,46204,19545
"Jackson, MS",2012,3017742,1031051,110960,20484,899607,789461,139890,34586,21572,7370,793,146,6431,5643,3338171,2438513,650576,464249,186327,249082,-7830,256912,65213,52331,12882,358,12524,51189,46598,20514
"Jackson, MS",2013,3013305,1055211,114480,16138,924593,769621,140260,34494,21484,7523,816,115,6592,5487,3540856,2603485,693219,492434,200785,244152,-2930,247082,66990,53816,13174,351,12823,52856,48378,19269
"Jackson, MS",2014,3061803,1087024,111087,8316,967621,785836,141374,34905,21657,7689,786,59,6844,5559,3593662,2631247,717955,519002,198953,244460,-8970,253430,67527,53906,13621,350,13271,53218,48812,19097
"Jackson, MS",2015,3028811,1140012,111632,6557,1021823,835039,141236,35429,21445,8072,790,46,7235,5912,3612077,2656668,714742,511629,203113,240667,-7665,248332,67598,53916,13682,341,13341,53435,49274,18614
"Jackson, MS",2016,3060477,1178217,109501,6637,1062079,841513,141550,35890,21621,8324,774,47,7503,5945,3635869,2669715,733658,529106,204552,232496,-8549,241045,68015,53510,14505,336,14169,53457,49892,17012
"Jackson, MS",2017,3107904,1198593,108472,5717,1084404,874858,142152,36449,21863,8432,763,40,7628,6154,3628543,2651240,726111,524586,201525,251192,-8167,259359,67358,52641,14717,333,14384,53870,50365,18031
"Jefferson Davis, LA",2001,368961,148952,14389,1530,133033,110153,31232,20110,11814,4769,461,49,4260,3527,275112,170685,42760,31570,11190,61667,20819,40848,10750,8031,2719,668,2051,25592,21253,19916
"Jefferson Davis, LA",2002,375399,157196,16383,2417,138396,102842,31113,20424,12066,5052,527,78,4448,3305,285459,184713,47802,35453,12349,52944,9430,43514,10962,8404,2558,582,1976,26041,21979,22021
"Jefferson Davis, LA",2003,413073,160928,17544,2409,140975,105408,31091,21852,13286,5176,564,77,4534,3390,333713,209261,55070,41132,13938,69382,30836,38546,11489,8951,2538,555,1983,29046,23379,19438
"Jefferson Davis, LA",2004,444292,170063,18484,1824,149755,102343,31076,23063,14297,5472,595,59,4819,3293,347400,217834,59295,45016,14279,70271,25328,44943,11428,8970,2458,538,1920,30399,24285,23408
"Jefferson Davis, LA",2005,491041,192697,25673,4599,162425,116805,31202,25657,15737,6176,823,147,5206,3744,361775,234510,62842,47707,15135,64423,14072,50351,11712,9113,2599,533,2066,30889,25734,24371
"Jefferson Davis, LA",2006,520237,200372,19456,1467,179449,133246,31489,27116,16521,6363,618,47,5699,4232,380620,250686,66660,50644,16016,63274,7432,55842,11980,9259,2721,522,2199,31771,27075,25394
"Jefferson Davis, LA",2007,548401,208651,20253,1110,187288,153006,31379,29002,17477,6649,645,35,5969,4876,405504,277726,70939,53182,17757,56839,13120,43719,12336,9484,2852,581,2271,32872,29284,19251
"Jefferson Davis, LA",2008,632780,229966,23468,1568,204930,182695,31497,33192,20090,7301,745,50,6506,5800,467904,312728,76093,56664,19429,79083,36538,42545,12639,9686,2953,578,2375,37021,32287,17914
"Jefferson Davis, LA",2009,600655,241206,24174,4311,212721,146834,31530,31357,19050,7650,767,137,6747,4657,467528,309249,79325,60199,19126,78954,35329,43625,12358,9506,2852,573,2279,37832,32532,19142
"Jefferson Davis, LA",2010,613293,249917,26599,5164,218154,138493,31634,31665,19387,7900,841,163,6896,4378,477169,311371,84893,65507,19386,80905,22315,58590,12266,9323,2943,563,2380,38902,33398,24618
"Jefferson Davis, LA",2011,626689,247284,26022,3738,217524,159577,31590,32718,19838,7828,824,118,6886,5052,463887,312494,81174,61492,19682,70219,12636,57583,12452,9316,3136,555,2581,37254,33544,22310
"Jefferson Davis, LA",2012,663901,251910,26885,2740,222285,167353,31448,34443,21111,8010,855,87,7068,5322,503223,331694,84508,63631,20877,87021,24539,62482,12560,9467,3093,542,2551,40066,35037,24493
"Jefferson Davis, LA",2013,720556,260116,25681,1779,232656,170717,31299,36787,23022,8311,821,57,7433,5454,552757,343254,89481,67946,21535,120022,47696,72326,12884,9606,3278,532,2746,42903,35733,26339
"Jefferson Davis, LA",2014,766500,264820,27014,1212,236594,169514,31450,38182,24372,8420,859,39,7523,5390,565715,356274,93629,71465,22164,115812,34342,81470,12900,9659,3241,531,2710,43854,36885,30063
"Jefferson Davis, LA",2015,719941,287676,27164,1607,258905,174359,31428,37609,22908,9153,864,51,8238,5548,506808,347297,95252,73553,21699,64259,5135,59124,12725,9457,3268,527,2741,39828,36724,21570
"Jefferson Davis, LA",2016,722486,308415,32351,1826,274238,171040,31370,38315,23031,9832,1031,58,8742,5452,497185,340419,95184,74054,21130,61582,16016,45566,12565,9314,3251,526,2725,39569,36549,16721
"Jefferson Davis, LA",2017,763809,324040,29808,1366,292866,176780,31477,40176,24266,10295,947,43,9304,5616,499349,340054,95764,74703,21061,63531,22697,40834,12521,9226,3295,518,2777,39881,36858,14704
"Jefferson, FL",2001,215037,60291,8297,754,51240,72130,12871,26995,16707,4684,645,59,3981,5604,114437,72534,20646,15605,5041,21257,1038,20219,4786,3144,1642,449,1193,23911,23071,16948
"Jefferson, FL",2002,217662,65118,8110,1049,55959,67207,13316,26283,16346,4890,609,79,4202,5047,115589,73513,22159,16980,5179,19917,-2312,22229,4746,3071,1675,419,1256,24355,23938,17698
"Jefferson, FL",2003,226873,72075,8897,1037,62141,68396,13602,27007,16679,5299,654,76,4569,5028,124488,79987,23720,18057,5663,20781,-2184,22965,4932,3251,1681,429,1252,25241,24604,18343
"Jefferson, FL",2004,238076,74059,9220,550,64289,72450,14030,27412,16969,5279,657,39,4582,5164,135347,86581,26031,19847,6184,22735,-720,23455,5060,3319,1741,445,1296,26748,26086,18098
"Jefferson, FL",2005,248510,79218,10965,438,67815,77793,14210,28538,17488,5575,772,31,4772,5475,136092,90161,26555,20172,6383,19376,-519,19895,5119,3253,1866,462,1404,26586,27716,14170
"Jefferson, FL",2006,253365,84881,11399,438,73044,87767,14461,29459,17521,5870,788,30,5051,6069,142231,96196,26810,19929,6881,19225,-736,19961,5234,3298,1936,472,1464,27174,29168,13635
"Jefferson, FL",2007,263091,89248,11074,507,77667,99658,14383,31426,18292,6205,770,35,5400,6929,146010,98601,27903,20901,7002,19506,-1477,20983,5313,3250,2063,575,1488,27482,30339,14101
"Jefferson, FL",2008,254937,100109,11614,997,87498,103950,14606,31425,17454,6854,795,68,5991,7117,141057,95710,27748,20947,6801,17599,-1255,18854,5250,3151,2099,570,1529,26868,30374,12331
"Jefferson, FL",2009,252117,107831,13404,2842,91585,105821,14704,31676,17146,7333,912,193,6229,7197,136125,89692,26221,19693,6528,20212,-656,20868,4927,2870,2057,568,1489,27628,31252,14015
"Jefferson, FL",2010,252603,116695,14645,3225,98825,95661,14748,31527,17128,7913,993,219,6701,6486,136725,83436,26127,20048,6079,27162,3812,23350,4804,2746,2058,567,1491,28461,30385,15661
"Jefferson, FL",2011,252613,119030,15339,2598,101093,121214,14519,33946,17399,8198,1056,179,6963,8349,135171,81187,24725,18700,6025,29259,5287,23972,4794,2709,2085,567,1518,28196,29969,15792
"Jefferson, FL",2012,263223,119739,14468,1737,103534,100049,14209,33993,18525,8427,1018,122,7287,7041,147351,83486,25005,18772,6233,38860,13560,25300,4779,2686,2093,559,1534,30833,31082,16493
"Jefferson, FL",2013,255224,124050,14661,1028,108361,101506,14201,33855,17972,8735,1032,72,7631,7148,142966,85155,25590,19380,6210,32221,13074,19147,4817,2647,2170,561,1609,29679,32170,11900
"Jefferson, FL",2014,269488,134415,14546,534,119335,107762,14046,36428,19186,9570,1036,38,8496,7672,153879,87986,25644,19200,6444,40249,20219,20030,4932,2700,2232,560,1672,31200,32587,11980
"Jefferson, FL",2015,276685,139445,13851,321,125273,114533,14099,37638,19624,9890,982,23,8885,8123,159935,89005,25239,18835,6404,45691,23938,21753,4838,2653,2185,554,1631,33058,33549,13337
"Jefferson, FL",2016,281302,143695,12919,259,130517,124511,13933,39439,20190,10313,927,19,9367,8936,154354,92968,25578,18910,6668,35808,14546,21262,4861,2659,2202,551,1651,31754,34964,12878
"Jefferson, FL",2017,296384,150052,13322,181,136549,130102,14144,40762,20955,10609,942,13,9654,9198,160496,94858,25678,18873,6805,39960,18286,21674,4976,2739,2237,550,1687,32254,34632,12848
"Jefferson, LA",2001,10971072,1944669,189515,22106,1733048,2273933,453154,33520,24210,4291,418,49,3824,5018,11343494,6702683,1396191,925700,470491,3244620,261,3244359,270855,226620,44235,57,44178,41880,29577,73438
"Jefferson, LA",2002,11324444,2033180,213696,37056,1782428,2216649,453429,34348,24975,4484,471,82,3931,4889,11803567,6923178,1492764,1004586,488178,3387625,90,3387535,270659,224711,45948,46,45902,43610,30809,73799
"Jefferson, LA",2003,10619249,2042859,223697,35547,1783615,2215558,454533,32732,23363,4494,492,78,3924,4874,11184304,7223177,1582348,1076365,505983,2378779,164,2378615,274331,227293,47038,45,46993,40769,31779,50616
"Jefferson, LA",2004,9989598,2222931,241143,28808,1952980,2248887,456602,31672,21878,4868,528,63,4277,4925,10640795,7581789,1674805,1153123,521682,1384201,122,1384079,275120,227761,47359,45,47314,38677,33288,29253
"Jefferson, LA",2005,10277876,2867691,539381,53601,2274709,2112295,456554,33420,22512,6281,1181,117,4982,4627,10963758,7628856,1677134,1173556,503578,1657768,486,1657282,255091,212271,42820,45,42775,42980,35939,38744
"Jefferson, LA",2006,11124408,2458685,227531,31606,2199548,2809103,426285,38454,26096,5768,534,74,5160,6590,12255388,8198822,1702802,1170307,532495,2353764,598,2353166,254839,203461,51378,44,51334,48091,40297,45840
"Jefferson, LA",2007,11605830,2524430,248330,17601,2258499,4592345,432683,43271,26823,5834,574,41,5220,10614,12859101,8756020,1801473,1238877,562596,2301608,243,2301365,265423,211695,53728,50,53678,48448,41361,42874
"Jefferson, LA",2008,12465692,2872027,285113,25402,2561512,3555220,431759,43758,28872,6652,660,59,5933,8234,13611113,9125989,1853238,1271792,581446,2631886,38,2631848,268981,212746,56235,51,56184,50603,42896,46843
"Jefferson, LA",2009,11571912,2986886,300180,67267,2619439,3053941,431921,40778,26792,6915,695,156,6065,7071,13027898,9038600,1907723,1328889,578834,2081575,353,2081222,266373,208530,57843,52,57791,48908,43344,36013
"Jefferson, LA",2010,12054120,3253593,343750,81147,2828696,2960420,432679,42221,27859,7520,794,188,6538,6842,13660378,9222572,2048452,1452564,595888,2389354,919,2388435,267347,207568,59779,51,59728,51096,44432,39989
"Jefferson, LA",2011,12136588,3279499,356450,60944,2862105,3104722,434034,42671,27962,7556,821,140,6594,7153,13703826,9411349,1912074,1295453,616621,2380403,4920,2375483,266137,206282,59855,51,59804,51492,45624,39721
"Jefferson, LA",2012,12546646,3299872,375822,45973,2878077,3590314,434559,44728,28872,7594,865,106,6623,8262,14055129,9512369,1953064,1329107,623957,2589696,1665,2588031,269404,206909,62495,51,62444,52171,45974,41446
"Jefferson, LA",2013,12514515,3426715,370312,29049,3027354,3512267,435197,44700,28756,7874,851,67,6956,8071,14007210,9559127,1987336,1355148,632188,2460747,3605,2457142,273331,208206,65125,51,65074,51246,45912,37759
"Jefferson, LA",2014,12907136,3441605,371133,20072,3050400,3702429,435585,46033,29632,7901,852,46,7003,8500,14327158,9749255,2058156,1422370,635786,2519747,926,2518821,274552,208491,66061,51,66010,52184,46761,38158
"Jefferson, LA",2015,13094649,3786599,375299,24184,3387116,3897524,436888,47561,29973,8667,859,55,7753,8921,14556307,10149474,2135626,1474260,661366,2271207,829,2270378,278790,210406,68384,52,68332,52212,48238,33226
"Jefferson, LA",2016,12775761,4006612,407112,25930,3573570,3944042,438485,47268,29136,9137,928,59,8150,8995,14421556,10157098,2136504,1474201,662303,2127954,750,2127204,279929,209156,70773,52,70721,51519,48562,30079
"Jefferson, LA",2017,13048455,4182547,380888,20383,3781276,4090107,439036,48563,29721,9527,868,46,8613,9316,14747074,10340996,2197177,1522611,674566,2208901,506,2208395,279670,207547,72123,51,72072,52730,49825,30642
"Jefferson, TX",2001,4165048,1181181,116662,27894,1036625,1011863,250137,25418,16651,4722,466,112,4144,4045,5727410,4047563,987866,714437,273429,691981,366,691615,144649,125364,19285,773,18512,39595,32286,37360
"Jefferson, TX",2002,4224029,1267730,126745,36387,1104598,947633,250146,25743,16886,5068,507,145,4416,3788,5811450,4089127,986688,708834,277854,735635,463,735172,144277,124096,20181,759,19422,40280,32951,37853
"Jefferson, TX",2003,4364277,1334806,140945,39979,1153882,981878,250183,26704,17444,5335,563,160,4612,3925,6109016,4289484,1106980,799811,307169,712552,5104,707448,145943,125022,20921,717,20204,41859,34310,35015
"Jefferson, TX",2004,4475443,1379466,150192,25898,1203376,937042,250638,27099,17856,5504,599,103,4801,3739,6260950,4392673,1111055,802017,309038,757222,8809,748413,144034,123339,20695,691,20004,43469,35615,37413
"Jefferson, TX",2005,4627975,1593120,199387,20236,1373497,976275,250849,28692,18449,6351,795,81,5475,3892,6556189,4665355,1169068,839886,329182,721766,7544,714222,146079,123352,22727,679,22048,44881,37821,32394
"Jefferson, TX",2006,5028481,1539896,160413,14996,1364487,1051918,245962,30982,20444,6261,652,61,5548,4277,7195932,5144841,1305954,945972,359982,745137,10143,734994,152450,128045,24405,654,23751,47202,40180,30946
"Jefferson, TX",2007,5090625,1650686,164651,15495,1470540,1153094,247629,31880,20557,6666,665,63,5938,4657,7422556,5466404,1300879,923766,377113,655273,4131,651142,154644,130607,24037,686,23351,47998,41854,27885
"Jefferson, TX",2008,5354126,1813458,191650,26519,1595289,1332883,249430,34080,21465,7270,768,106,6396,5344,7947014,5891303,1347833,953557,394276,707878,2234,705644,157127,132286,24841,686,24155,50577,44535,29213
"Jefferson, TX",2009,5285352,1948619,207591,75147,1665881,1214556,251332,33615,21029,7753,826,299,6628,4832,7778585,5665642,1386745,1002493,384252,726198,2379,723819,152982,126884,26098,681,25417,50846,44652,28478
"Jefferson, TX",2010,5451569,2119571,229277,91971,1798323,1327953,252453,35250,21594,8396,908,364,7123,5260,8051466,5750267,1450386,1033934,416452,850813,-2003,852816,152225,126240,25985,681,25304,52892,45550,33703
"Jefferson, TX",2011,5662021,2176377,237206,77005,1862166,1356501,253397,36287,22344,8589,936,304,7349,5353,8398116,6124411,1461376,1022741,438635,812329,-5009,817338,156397,128744,27653,678,26975,53697,47570,30300
"Jefferson, TX",2012,5903701,2158502,242142,71162,1845198,1592278,251458,38394,23478,8584,963,283,7338,6332,8733390,6372936,1520911,1070696,450215,839543,-6274,845817,155726,128788,26938,671,26267,56082,49484,32201
"Jefferson, TX",2013,5741920,2214993,245958,54783,1914252,1432343,253022,37108,22693,8754,972,217,7566,5661,8568651,6172429,1573289,1135127,438162,822933,514,822419,152294,124516,27778,676,27102,56264,49571,30345
"Jefferson, TX",2014,6351922,2314487,249736,32153,2032598,1607284,252708,40654,25135,9159,988,127,8043,6360,9399937,6770342,1700775,1228010,472765,928820,-1807,930627,157309,129389,27920,668,27252,59755,52325,34149
"Jefferson, TX",2015,6703691,2426562,245212,36655,2144695,1568278,254889,41973,26300,9520,962,144,8414,6153,9903337,7119831,1812395,1319115,493280,971111,-4076,975187,159031,130622,28409,659,27750,62273,54507,35142
"Jefferson, TX",2016,6624307,2542009,246425,37938,2257646,1483247,255954,41607,25881,9932,963,148,8821,5795,9850358,7135828,1807028,1311080,495948,907502,-4967,912469,156993,129377,27616,657,26959,62744,55155,33847
"Jefferson, TX",2017,6704308,2593245,268826,33468,2290951,1553758,256299,42338,26158,10118,1049,131,8939,6062,9958445,7284884,1831776,1319831,511945,841785,-6815,848600,156883,128730,28153,653,27500,63477,56590,30858
"Lafourche, LA",2001,1460834,360136,37759,3778,318599,421611,90105,24889,16213,3997,419,42,3536,4679,1348323,972798,223384,159125,64259,152141,328,151813,41092,33249,7843,417,7426,32812,29258,20443
"Lafourche, LA",2002,1536058,375048,40284,6415,328349,415150,90994,25565,16881,4122,443,70,3608,4562,1443088,1035365,247798,179410,68388,159925,116,159809,42559,34185,8374,357,8017,33908,30287,19934
"Lafourche, LA",2003,1601746,385890,42835,6437,336618,412576,91899,26118,17429,4199,466,70,3663,4489,1517364,1092310,268860,196286,72574,156194,2003,154191,44165,35884,8281,340,7941,34357,30440,19417
"Lafourche, LA",2004,1627250,430431,48123,5604,376704,383811,92580,26372,17577,4649,520,61,4069,4146,1549003,1109194,280143,208796,71347,159666,1458,158208,43597,35239,8358,329,8029,35530,31476,19705
"Lafourche, LA",2005,1801488,471789,61112,13994,396683,462508,92656,29526,19443,5092,660,151,4281,4992,1745212,1210515,301005,226089,74916,233692,2640,231052,44801,35677,9124,324,8800,38955,33930,26256
"Lafourche, LA",2006,2184626,495033,54166,4544,436323,618013,94385,34939,23146,5245,574,48,4623,6548,2151298,1434661,343083,254644,88439,373554,12277,361277,47172,37209,9963,315,9648,45605,38557,37446
"Lafourche, LA",2007,2469444,519983,56138,3101,460744,651672,94745,38431,26064,5488,593,33,4863,6878,2542598,1705981,384379,281136,103243,452238,3513,448725,49311,39366,9945,347,9598,51562,43336,46752
"Lafourche, LA",2008,2630633,595212,64790,4554,525868,776428,95603,41863,27516,6226,678,48,5501,8121,2698035,1873852,414874,301101,113773,409309,13715,395594,51012,41071,9941,350,9591,52890,45625,41246
"Lafourche, LA",2009,2478991,627210,66158,11097,549955,711504,96080,39735,25801,6528,689,115,5724,7405,2546466,1826272,423535,312422,111113,296659,14389,282270,50283,40227,10056,350,9706,50643,45399,29082
"Lafourche, LA",2010,2613295,680240,74165,14005,592070,602956,96737,40279,27014,7032,767,145,6120,6233,2796609,1888340,460329,344725,115604,447940,20999,426941,50049,39608,10441,347,10094,55877,47676,42297
"Lafourche, LA",2011,2663319,677046,74301,10771,591974,532296,97011,39920,27454,6979,766,111,6102,5487,2836499,1896072,441790,323370,118420,498637,22821,475816,49694,39770,9924,345,9579,57079,47676,49673
"Lafourche, LA",2012,2716039,677820,76283,7665,593872,698359,97177,42111,27949,6975,785,79,6111,7186,2976070,2074748,477599,349167,128432,423723,19829,403894,51046,40643,10403,335,10068,58302,51048,40117
"Lafourche, LA",2013,2711188,701651,74433,5022,622196,795327,97254,43270,27877,7215,765,52,6398,8178,3117537,2295766,524714,383420,141294,297057,18732,278325,53396,42564,10832,330,10502,58385,53937,26502
"Lafourche, LA",2014,2816875,711490,74362,3657,633471,969601,97901,45944,28773,7267,760,37,6471,9904,3331222,2471053,557397,406551,150846,302772,14974,287798,54913,43761,11152,329,10823,60664,56467,26591
"Lafourche, LA",2015,2744872,778019,72768,4802,700449,923408,98363,45203,27906,7910,740,49,7121,9388,2976961,2154721,519798,384370,135428,302442,14225,288217,51312,40324,10988,327,10661,58017,53435,27035
"Lafourche, LA",2016,2463834,834631,85105,6090,743436,911818,98617,42693,24984,8463,863,62,7539,9246,2565947,1860421,464165,349229,114936,241361,10545,230816,48992,37360,11632,326,11306,52375,49797,20415
"Lafourche, LA",2017,2532391,874395,80930,4496,788969,942890,98426,44192,25729,8884,822,46,8016,9580,2609349,1781842,460327,349685,110642,367180,10041,357139,48139,36293,11846,322,11524,54204,49096,30991
"Liberty, TX",2001,1117183,281265,26185,6535,248545,167828,71679,21851,15586,3924,365,91,3467,2341,658430,418604,99169,71050,28119,140657,-92,140749,24680,16712,7968,1607,6361,26679,25048,22127
"Liberty, TX",2002,1116512,312097,30156,13249,268692,161701,73280,21702,15236,4259,412,181,3667,2207,663114,421853,102982,74606,28376,138279,-177,138456,23951,16588,7363,1557,5806,27686,25431,23847
"Liberty, TX",2003,1136973,333994,34518,11895,287581,174409,73734,22315,15420,4530,468,161,3900,2365,711601,443649,115312,83829,31483,152640,3776,148864,24146,16838,7308,1494,5814,29471,26348,25604
"Liberty, TX",2004,1204369,345742,38042,7855,299845,166216,74285,23105,16213,4654,512,106,4036,2238,759851,465841,121858,89116,32742,172152,3419,168733,24075,16917,7158,1434,5724,31562,27537,29478
"Liberty, TX",2005,1287451,391491,47183,4894,339414,170262,74303,24887,17327,5269,635,66,4568,2291,832632,507140,129101,93710,35391,196391,1167,195224,24947,17435,7512,1418,6094,33376,29087,32035
"Liberty, TX",2006,1389212,400093,43004,3858,353231,176620,74269,26470,18705,5387,579,52,4756,2378,888773,553557,137718,99911,37807,197498,3476,194022,25849,18140,7709,1368,6341,34383,30516,30598
"Liberty, TX",2007,1428257,438364,42701,3982,391681,195646,74515,27676,19167,5883,573,53,5256,2626,863718,579472,136587,97377,39210,147659,-127,147786,26049,18190,7859,1440,6419,33157,31857,23023
"Liberty, TX",2008,1431376,482494,47994,6390,428110,245643,74915,28826,19107,6441,641,85,5715,3279,872505,621848,139440,98782,40658,111217,-8321,119538,26253,18353,7900,1413,6487,33234,33883,18427
"Liberty, TX",2009,1329147,527684,56512,21605,449567,224677,75041,27738,17712,7032,753,288,5991,2994,835230,600907,142214,102160,40054,92109,-9583,101692,26052,18020,8032,1392,6640,32060,33347,15315
"Liberty, TX",2010,1351742,576036,64320,24630,487086,216918,75856,28273,17820,7594,848,325,6421,2860,887530,611492,148299,105884,42415,127739,-9092,136831,25532,17626,7906,1380,6526,34761,34693,20967
"Liberty, TX",2011,1482793,591900,65204,19255,507441,241242,75970,30485,19518,7791,858,253,6679,3175,943201,637532,146638,102428,44210,159031,-10701,169732,25447,17390,8057,1362,6695,37065,36661,25352
"Liberty, TX",2012,1574319,601467,63428,15666,522373,262273,76340,31937,20622,7879,831,205,6843,3436,1024728,699748,160570,111735,48835,164410,-4617,169027,26030,18156,7874,1333,6541,39367,38541,25841
"Liberty, TX",2013,1660715,617968,63213,11720,543035,247366,76827,32880,21616,8044,823,153,7068,3220,1025079,686380,165830,118161,47669,172869,-2380,175249,25980,17802,8178,1339,6839,39456,38556,25625
"Liberty, TX",2014,1774964,636456,63519,7648,565289,264503,78014,34301,22752,8158,814,98,7246,3390,1067341,724685,172523,122599,49924,170133,-2089,172222,26360,18001,8359,1323,7036,40491,40258,24477
"Liberty, TX",2015,1823820,693588,66757,10588,616243,290112,79542,35296,22929,8720,839,133,7747,3647,1081011,729374,181982,131869,50113,169655,-3636,173291,26816,18041,8775,1296,7479,40312,40429,23170
"Liberty, TX",2016,1879158,733571,71555,11778,650238,281533,81377,35566,23092,9014,879,145,7990,3460,1060145,731818,184264,134103,50161,144063,-6456,150519,26902,18019,8883,1292,7591,39408,40614,19829
"Liberty, TX",2017,1948577,755200,81341,9543,664316,294560,83658,35840,23292,9027,972,114,7941,3521,1132523,792242,197225,142020,55205,143056,-6659,149715,27311,18280,9031,1284,7747,41468,43339,19326
"Mobile, AL",2001,5942962,1795540,216476,29450,1549614,1533587,400129,23173,14853,4487,541,74,3873,3833,7374022,5398841,1208003,809540,398463,767178,-126,767304,215385,185318,30067,772,29295,34236,29133,26192
"Mobile, AL",2002,6052415,1860667,244477,38492,1577698,1497796,398549,23613,15186,4669,613,97,3959,3758,7491097,5426583,1237309,831668,405641,827205,-248,827453,213117,182405,30712,679,30033,35150,29750,27551
"Mobile, AL",2003,6115867,1947960,266655,39239,1642066,1574566,398082,24212,15363,4893,670,99,4125,3955,7534180,5482811,1289300,878185,411115,762069,11824,750245,211180,179834,31346,659,30687,35677,30488,24448
"Mobile, AL",2004,6330370,2067714,302157,26259,1739298,1664404,397959,25285,15907,5196,759,66,4371,4182,7771283,5696973,1362821,939637,423184,711489,13913,697576,212787,179976,32811,643,32168,36521,31654,21685
"Mobile, AL",2005,6864857,2330697,358252,22101,1950344,1667657,398942,27230,17208,5842,898,55,4889,4180,8412310,6143627,1471044,1010016,461028,797639,6858,790781,218945,184313,34632,650,33982,38422,33333,23271
"Mobile, AL",2006,7736996,2383796,312412,19715,2051669,1874921,402916,29772,19203,5916,775,49,5092,4653,9401702,6766584,1513634,1031635,481999,1121484,19607,1101877,226409,188454,37955,645,37310,41525,35906,29533
"Mobile, AL",2007,7908941,2487909,352631,20752,2114526,2015945,405715,30595,19494,6132,869,51,5212,4969,9636444,7049753,1575274,1065938,509336,1011417,7532,1003885,233054,192134,40920,744,40176,41349,36692,24987
"Mobile, AL",2008,7949789,2826400,372401,32525,2421474,2110418,409196,31493,19428,6907,910,79,5918,5157,9748842,7336555,1643230,1113036,530194,769057,7079,761978,234073,192919,41154,707,40447,41649,38029,18839
"Mobile, AL",2009,7684564,2963955,432848,91966,2439141,1943970,411994,30565,18652,7194,1051,223,5920,4718,9557729,7177450,1713825,1192678,521147,666454,19045,647409,225897,183314,42583,680,41903,42310,39154,15450
"Mobile, AL",2010,7871817,3295987,484283,107400,2704304,2049909,413320,31979,19045,7974,1172,260,6543,4960,9912939,7325775,1769228,1215916,553312,817936,9110,808826,226900,183224,43676,658,43018,43689,39983,18802
"Mobile, AL",2011,8407377,3365360,509711,89759,2765890,2142891,413232,33675,20345,8144,1233,217,6693,5186,10559524,7614705,1829721,1246555,583166,1115098,14543,1100555,233197,182072,51125,630,50495,45282,41822,21795
"Mobile, AL",2012,8322920,3355880,504155,63154,2788571,2178780,413737,33494,20116,8111,1219,153,6740,5266,10467562,7620034,1727693,1151333,576360,1119835,26800,1093035,229435,180322,49113,585,48528,45623,42258,22524
"Mobile, AL",2013,8322534,3410436,511307,45157,2853972,2303962,413929,33911,20106,8239,1235,109,6895,5566,10567728,7669227,1778243,1196375,581868,1120258,35280,1084978,228792,180155,48637,594,48043,46189,42570,22583
"Mobile, AL",2014,8519211,3577079,501589,25632,3049858,2258352,414314,34647,20562,8634,1211,62,7361,5451,10828502,7897513,1861393,1271344,590049,1069596,18091,1051505,231064,181911,49153,593,48560,46864,43414,21654
"Mobile, AL",2015,8796150,3706020,501331,22083,3182606,2391526,414588,35924,21217,8939,1209,53,7677,5768,11263204,8189790,1968893,1357560,611333,1104521,20766,1083755,233931,183792,50139,588,49551,48148,44560,21872
"Mobile, AL",2016,8814757,3763202,490621,21313,3251268,2412989,414852,36136,21248,9071,1183,51,7837,5817,11469661,8405991,1996908,1381689,615219,1066762,28620,1038142,235988,185749,50239,598,49641,48603,45255,20913
"Mobile, AL",2017,8961718,3879110,474560,18227,3386323,2512282,413955,37089,21649,9371,1146,44,8180,6069,11756700,8673652,2055182,1424660,630522,1027866,26378,1001488,237745,186709,51036,593,50443,49451,46455,19854
"Montgomery, TX",2001,8377628,880070,70034,15622,794414,1451548,311437,34387,26900,2826,225,50,2551,4661,4289326,2820116,551658,363966,187692,917552,-1543,919095,124430,86962,37468,1688,35780,34472,32429,25687
"Montgomery, TX",2002,8530661,999301,80745,32615,885941,1412011,326466,33516,26130,3061,247,100,2714,4325,4489769,2926234,596347,399158,197189,967188,-1079,968267,129413,89508,39905,1648,38257,34693,32692,25310
"Montgomery, TX",2003,8882721,1097851,94200,39863,963788,1500877,341499,33621,26011,3215,276,117,2822,4395,4772075,3093524,662889,440215,222674,1015662,307,1015355,137139,93364,43775,1614,42161,34797,33134,24083
"Montgomery, TX",2004,9555270,1207591,108640,26547,1072404,1629083,357607,34652,26720,3377,304,74,2999,4556,5190433,3413786,718276,474311,243965,1058371,2672,1055699,146233,99650,46583,1584,44999,35494,34258,23460
"Montgomery, TX",2005,11049338,1345603,133440,20390,1191773,2041894,372541,38752,29659,3612,358,55,3199,5481,6324836,4208963,869012,577026,291986,1246861,2632,1244229,166865,114778,52087,1601,50486,37904,36670,24645
"Montgomery, TX",2006,12841627,1513334,140583,18425,1354326,2532034,392497,43025,32718,3856,358,47,3451,6451,7267411,4778236,953477,635418,318059,1535698,3327,1532371,177557,122039,55518,1577,53941,40930,39153,28408
"Montgomery, TX",2007,14391060,1695137,147692,19133,1528312,3091046,411416,46613,34979,4120,359,47,3715,7513,7797469,5214236,1007866,664549,343317,1575367,1537,1573830,187669,129792,57877,1697,56180,41549,40174,28014
"Montgomery, TX",2008,16285351,2012249,170270,31103,1810876,3713548,429818,51210,37889,4682,396,72,4213,8640,9310484,5713168,1073755,706968,366787,2523561,-432,2523993,198977,135842,63135,1636,61499,46792,42057,41041
"Montgomery, TX",2009,15497204,2229536,206353,102518,1920665,3411333,445836,47412,34760,5001,463,230,4308,7652,8936926,5816066,1154127,774523,379604,1966733,-1353,1968086,203532,137135,66397,1582,64815,43909,42411,30365
"Montgomery, TX",2010,16704900,2512877,242944,117596,2152337,3358832,459185,49167,36379,5472,529,256,4687,7315,9699133,6063371,1229241,817456,411785,2406521,-3624,2410145,206264,138935,67329,1540,65789,47023,43642,36634
"Montgomery, TX",2011,18340956,2642680,251706,93217,2297757,3604579,471438,52156,38904,5606,534,198,4874,7646,10642042,6518466,1265219,821842,443377,2858357,-7555,2865912,212932,143760,69172,1491,67681,49979,45343,42344
"Montgomery, TX",2012,22029931,2671629,251890,77334,2342405,4217354,484453,59694,45474,5515,520,160,4835,8705,13912313,7393895,1414265,916137,498128,5104153,-7014,5111167,224219,153159,71060,1431,69629,62048,48276,73406
"Montgomery, TX",2013,24027435,2812756,254121,58204,2500431,4141143,498467,62153,48203,5643,510,117,5016,8308,16073353,8029962,1585329,1047415,537914,6458062,456,6457606,235935,161046,74889,1440,73449,68126,49861,87920
"Montgomery, TX",2014,25525147,3015497,262897,37806,2714794,4766084,516798,64448,49391,5835,509,73,5253,9222,17078092,8829386,1715104,1129396,585708,6533602,-1711,6535313,247697,169820,77877,1424,76453,68948,51993,85481
"Montgomery, TX",2015,23506514,3270898,259704,52564,2958630,5137385,535214,59630,43920,6111,485,98,5528,9599,14491913,9307815,1865198,1246348,618850,3318900,2374,3316526,259238,177715,81523,1402,80121,55902,52375,41394
"Montgomery, TX",2016,22901677,3492336,275107,63313,3153916,4746454,554522,56157,41300,6298,496,114,5688,8560,13859571,9511698,1904104,1269100,635004,2443769,-2911,2446680,265163,181710,83453,1398,82055,52268,52345,29818
"Montgomery, TX",2017,24265394,3653115,325739,48599,3278777,4958695,570934,57585,42501,6398,571,85,5743,8685,15257332,10217542,2042098,1350944,691154,2997692,-3336,3001028,274577,189206,85371,1389,83982,55567,54002,35734
"Pike, MS",2001,441914,217737,30454,2579,184704,127157,38739,20310,11407,5621,786,67,4768,3282,514719,361858,87174,59391,27783,65687,10844,54843,19762,16410,3352,581,2771,26046,22051,19792
"Pike, MS",2002,450299,237300,32493,3602,201205,124976,38734,20978,11625,6126,839,93,5195,3227,523383,368499,91294,63148,28146,63590,5031,58559,19655,16282,3373,507,2866,26628,22632,20432
"Pike, MS",2003,467287,241116,34284,3200,203632,124046,38649,21539,12091,6239,887,83,5269,3210,542783,382477,96175,67165,29010,64131,4770,59361,19867,16242,3625,515,3110,27321,23549,19087
"Pike, MS",2004,491950,254523,35455,2545,216523,110826,38700,22152,12712,6577,916,66,5595,2864,578262,397762,105466,74902,30564,75034,10739,64295,20567,16471,4096,504,3592,28116,24149,17899
"Pike, MS",2005,517131,280832,43969,3152,233711,124456,38905,23710,13292,7218,1130,81,6007,3199,610432,419785,111509,80100,31409,79138,9878,69260,20932,16584,4348,513,3835,29163,25313,18060
"Pike, MS",2006,552929,287309,39325,2262,245722,136292,40241,24267,13740,7140,977,56,6106,3387,661533,469341,118417,83195,35222,73775,-1340,75115,21983,17323,4660,508,4152,30093,27094,18091
"Pike, MS",2007,555708,297808,41745,2102,253961,147130,40141,24928,13844,7419,1040,52,6327,3665,661522,469780,118906,84102,34804,72836,-704,73540,22039,16997,5042,512,4530,30016,27639,16234
"Pike, MS",2008,584841,329242,43763,3090,282389,164420,40290,26769,14516,8172,1086,77,7009,4081,700782,508455,124841,87231,37610,67486,-484,67970,22312,17195,5117,494,4623,31408,29570,14703
"Pike, MS",2009,547354,352387,51261,7791,293335,152117,40332,26080,13571,8737,1271,193,7273,3772,651682,463329,118116,83280,34836,70237,2439,67798,21500,16212,5288,481,4807,30311,28579,14104
"Pike, MS",2010,564736,376896,56824,8364,311708,150332,40447,26997,13962,9318,1405,207,7707,3717,670962,465660,117321,82677,34644,87981,3347,84634,20976,15714,5262,469,4793,31987,29633,17658
"Pike, MS",2011,560140,385695,58524,6826,320345,164054,40430,27452,13855,9540,1448,169,7923,4058,666661,468039,115725,79348,36377,82897,-7285,90182,20696,15469,5227,454,4773,32212,30257,18894
"Pike, MS",2012,594879,380658,59836,5594,315228,160752,40086,28346,14840,9496,1493,140,7864,4010,702629,481522,120629,83287,37342,100478,773,99705,20580,15451,5129,436,4693,34141,31164,21245
"Pike, MS",2013,606158,390010,58444,4366,327200,157162,39942,28875,15176,9764,1463,109,8192,3935,725944,488763,123986,86999,36987,113195,13031,100164,20575,15446,5129,432,4697,35283,31643,21325
"Pike, MS",2014,631482,406475,57716,2124,346635,164327,39937,30105,15812,10178,1445,53,8680,4115,750034,498723,130440,93037,37403,120871,15567,105304,20984,15759,5225,430,4795,35743,31647,21961
"Pike, MS",2015,604355,418961,58259,1713,358989,173628,39862,30027,15161,10510,1462,43,9006,4356,727344,509236,126396,88125,38271,91712,5588,86124,21350,15837,5513,427,5086,34068,32155,16934
"Pike, MS",2016,585358,433160,56530,1731,374899,170204,39608,30012,14779,10936,1427,44,9465,4297,710282,511565,129217,91379,37838,69500,627,68873,21076,15701,5375,420,4955,33701,32582,13900
"Pike, MS",2017,596326,436265,54166,1473,380626,176737,39468,30641,15109,11054,1372,37,9644,4478,727173,527044,132643,93486,39157,67486,6157,61329,21240,15782,5458,416,5042,34236,33395,12164
"Plaquemines, LA",2001,413195,137923,11968,1231,124724,90369,27029,23733,15287,5103,443,46,4614,3343,885179,661013,146524,100080,46444,77642,995,76647,21316,18435,2881,178,2703,41527,35856,28356
"Plaquemines, LA",2002,431068,142759,13272,2182,127305,85850,27462,24021,15697,5198,483,79,4636,3126,866193,635873,150978,107028,43950,79342,820,78522,19954,16749,3205,157,3048,43409,37965,25762
"Plaquemines, LA",2003,459815,139455,13818,2034,123603,88731,28169,24424,16323,4951,491,72,4388,3150,899116,662431,164170,118464,45706,72515,3063,69452,19889,16850,3039,148,2891,45207,39313,24024
"Plaquemines, LA",2004,495696,159440,15856,1665,141919,94007,29390,25490,16866,5425,540,57,4829,3199,927480,680138,169477,123178,46299,77865,2292,75573,19824,16688,3136,139,2997,46786,40756,25216
"Plaquemines, LA",2005,500978,202980,43817,4159,155004,91696,29558,26918,16949,6867,1482,141,5244,3102,941174,699462,174070,128543,45527,67642,2683,64959,18453,16029,2424,132,2292,51004,43637,28342
"Plaquemines, LA",2006,524836,130048,12463,3493,114092,110982,22329,34299,23505,5824,558,156,5110,4970,1042931,766045,189549,140292,49257,87337,11519,75818,18094,15415,2679,126,2553,57640,49695,29698
"Plaquemines, LA",2007,622359,127615,13313,782,113520,204565,22709,42034,27406,5620,586,34,4999,9008,1090262,817009,190616,138951,51665,82637,2608,80029,18725,15916,2809,135,2674,58225,51333,29929
"Plaquemines, LA",2008,659915,131068,14599,1046,115423,208731,22677,44085,29101,5780,644,46,5090,9205,1186928,878755,206222,151006,55216,101951,7344,94607,19301,16206,3095,128,2967,61496,54224,31886
"Plaquemines, LA",2009,630225,135129,15193,2622,117314,161686,22730,40785,27727,5945,668,115,5161,7113,1204512,871353,214164,158714,55450,118995,7265,111730,19293,16114,3179,124,3055,62433,54074,36573
"Plaquemines, LA",2010,686959,158955,16964,3085,138906,152991,23123,43200,29709,6874,734,133,6007,6616,1287790,915387,235136,176372,58764,137267,10258,127009,19813,16157,3656,118,3538,64997,56656,35899
"Plaquemines, LA",2011,680507,147155,14789,2689,129677,138306,23588,40952,28850,6239,627,114,5498,5863,1324354,955601,228416,166552,61864,140337,9557,130780,19768,16344,3424,112,3312,66995,58468,39487
"Plaquemines, LA",2012,702942,147423,16908,1984,128531,169745,23837,42795,29490,6185,709,83,5392,7121,1339673,965425,235382,173564,61818,138866,6235,132631,19639,16122,3517,106,3411,68215,59882,38883
"Plaquemines, LA",2013,723640,148316,16699,1302,130315,151222,23524,43495,30762,6305,710,55,5540,6428,1406916,990758,244855,180944,63911,171303,6151,165152,19697,16014,3683,103,3580,71428,61868,46132
"Plaquemines, LA",2014,782485,152577,16897,910,134770,155351,23322,46755,33551,6542,725,39,5779,6661,1492186,1029748,259933,193507,66426,202505,6397,196108,20231,16355,3876,103,3773,73757,62962,51977
"Plaquemines, LA",2015,756069,169960,17159,1112,151689,169142,23450,46702,32242,7248,732,47,6469,7213,1447775,1026985,264299,198693,65606,156491,5633,150858,19679,15921,3758,101,3657,73570,64505,41252
"Plaquemines, LA",2016,738510,181298,18426,1239,161633,179178,23327,47112,31659,7772,790,53,6929,7681,1350540,941137,253426,192847,60579,155977,4115,151862,18709,14878,3831,101,3730,72187,63257,40714
"Plaquemines, LA",2017,762646,189979,17557,983,171439,183635,23348,48666,32664,8137,752,42,7343,7865,1312866,895573,247469,189266,58203,169824,3950,165874,17892,14024,3868,99,3769,73377,63860,44010
"Santa Rosa, FL",2001,2142560,431005,30612,7008,393385,721573,121261,27174,17669,3554,252,58,3244,5951,1205248,795998,196345,140781,55564,212905,8587,204318,42296,29283,13013,521,12492,28496,27183,16356
"Santa Rosa, FL",2002,2258009,484153,35642,10932,437579,716399,127438,27139,17718,3799,280,86,3434,5622,1270415,827683,214654,155648,59006,228078,7753,220325,44170,30673,13497,476,13021,28762,26984,16921
"Santa Rosa, FL",2003,2477602,537758,40600,10326,486832,707794,131463,28321,18846,4091,309,79,3703,5384,1418647,914915,244960,179002,65958,258772,14976,243796,46126,32211,13915,473,13442,30756,28404,18137
"Santa Rosa, FL",2004,2720852,610647,64779,6770,539098,774307,137241,29917,19825,4449,472,49,3928,5642,1567421,1021717,272695,197877,74818,273009,7905,265104,48397,34263,14134,463,13671,32387,29820,19392
"Santa Rosa, FL",2005,2959243,641147,57007,4861,579279,863115,141132,31626,20968,4543,404,34,4105,6116,1756952,1162215,302059,217774,84285,292678,9955,282723,51313,36092,15221,462,14759,34240,32201,19156
"Santa Rosa, FL",2006,3181653,689245,57542,4660,627043,958043,142983,33773,22252,4820,402,33,4385,6700,1930943,1303843,318522,221927,96595,308578,13367,295211,52764,36956,15808,453,15355,36596,35281,19226
"Santa Rosa, FL",2007,3294570,753037,59835,6077,687125,1073997,146158,35042,22541,5152,409,42,4701,7348,1860972,1278853,321146,227013,94133,260973,3857,257116,53410,36831,16579,535,16044,34843,34722,16026
"Santa Rosa, FL",2008,3352838,868233,65573,12334,790326,1095004,148538,35789,22572,5845,441,83,5321,7372,1796249,1244139,326879,235456,91423,225231,6131,219100,51538,35385,16153,540,15613,34853,35160,14033
"Santa Rosa, FL",2009,3345943,938018,75333,31749,830936,1008272,149544,35389,22374,6273,504,212,5556,6742,1766152,1232064,325412,233805,91607,208676,2091,206585,50860,34524,16336,553,15783,34726,35687,13089
"Santa Rosa, FL",2010,3468792,1051702,86473,32560,932669,1030606,152911,36303,22685,6878,566,213,6099,6740,1822027,1224737,338521,245871,92650,258769,6883,251886,50606,34174,16432,568,15864,36004,35838,15878
"Santa Rosa, FL",2011,3653045,1101966,87118,24135,990713,1099180,155727,37593,23458,7076,559,155,6362,7058,1960491,1301827,343077,241825,101252,315587,10487,305100,52504,35842,16662,583,16079,37340,36321,18975
"Santa Rosa, FL",2012,3821746,1097702,87915,17461,992326,1161613,158205,38438,24157,6938,556,110,6272,7342,2062499,1355854,353842,246501,107341,352803,-2432,355235,53544,36667,16877,588,16289,38520,36978,21808
"Santa Rosa, FL",2013,3794730,1155013,92945,14072,1047996,1154265,160421,38050,23655,7200,579,88,6533,7195,1988922,1341400,360195,255516,104679,287327,1575,285752,53710,36356,17354,590,16764,37031,36896,17046
"Santa Rosa, FL",2014,3938940,1238116,92678,1910,1143528,1251979,162768,39498,24200,7607,569,12,7026,7692,2084730,1405386,366259,257937,108322,313085,-11851,324936,55261,37246,18015,589,17426,37725,37733,18647
"Santa Rosa, FL",2015,4113782,1338300,91092,3460,1243748,1286685,166365,40506,24727,8044,548,21,7476,7734,2247640,1518362,391166,276898,114268,338112,-6684,344796,57115,38750,18365,580,17785,39353,39184,19387
"Santa Rosa, FL",2016,4364334,1411283,88697,2875,1319711,1344827,170063,41869,25663,8299,522,17,7760,7908,2363461,1605575,391775,273997,117778,366111,-8621,374732,58437,39977,18460,577,17883,40445,40162,20955
"Santa Rosa, FL",2017,4599497,1484134,93744,2622,1387768,1394135,174272,42909,26393,8516,538,15,7963,8000,2459927,1660905,401058,280185,120873,397964,-6970,404934,59560,40757,18803,576,18227,41302,40751,22216
"Shelby, TX",2001,355991,131861,12863,1662,117336,84504,25171,22739,14143,5239,511,66,4662,3357,350926,178891,42784,30567,12217,129251,94883,34368,11582,8275,3307,1168,2139,30299,21618,16067
"Shelby, TX",2002,372384,142486,14099,3215,125172,76628,25155,23514,14804,5664,560,128,4976,3046,369445,186703,46293,33513,12780,136449,99670,36779,11469,8243,3226,1073,2153,32212,22650,17083
"Shelby, TX",2003,372101,149864,15237,3637,130990,79130,25407,23659,14646,5899,600,143,5156,3114,373279,197917,51098,36570,14528,124264,85078,39186,11467,8292,3175,1037,2138,32552,23868,18328
"Shelby, TX",2004,383850,155286,16141,2215,136930,71174,25212,24207,15225,6159,640,88,5431,2823,383144,199385,51316,36737,14579,132443,89633,42810,11252,8068,3184,998,2186,34051,24713,19584
"Shelby, TX",2005,388164,166640,17868,1665,147107,77159,25299,24980,15343,6587,706,66,5815,3050,388443,213573,53262,37475,15787,121608,73075,48533,11451,8151,3300,992,2308,33922,26202,21028
"Shelby, TX",2006,377987,176185,19180,1358,155647,84590,25324,25224,14926,6957,757,54,6146,3340,378878,232846,57092,40503,16589,88940,31717,57223,11686,8462,3224,959,2265,32422,27517,25264
"Shelby, TX",2007,391334,190798,19003,1347,170448,106804,25433,27088,15387,7502,747,53,6702,4199,389097,244064,59374,42038,17336,85659,21278,64381,12097,8742,3355,1012,2343,32165,27919,27478
"Shelby, TX",2008,402913,212989,20542,2130,190317,111960,25381,28677,15875,8392,809,84,7498,4411,398620,258477,59980,42129,17851,80163,15305,64858,12261,8829,3432,994,2438,32511,29276,26603
"Shelby, TX",2009,402230,223648,23195,6232,194221,108792,25520,28788,15761,8764,909,244,7611,4263,403635,256941,62755,44667,18088,83939,9566,74373,12091,8614,3477,979,2498,33383,29828,29773
"Shelby, TX",2010,500000,240859,26390,7028,207441,113831,25457,33574,19641,9461,1037,276,8149,4472,499581,274025,67332,47367,19965,158224,60801,97423,12401,8775,3626,970,2656,40286,31228,36680
"Shelby, TX",2011,460012,244428,26763,6107,211558,123106,25730,32163,17878,9500,1040,237,8222,4785,442876,277132,66680,46917,19763,99064,13270,85794,12493,8782,3711,957,2754,35450,31557,31153
"Shelby, TX",2012,529265,243858,27086,5693,211079,125552,26059,34486,20310,9358,1039,218,8100,4818,508626,310212,73985,51757,22228,124429,29385,95044,12925,9206,3719,935,2784,39352,33697,34139
"Shelby, TX",2013,532157,249800,27390,3874,218536,119698,25984,34700,20480,9614,1054,149,8410,4607,507707,292345,73923,53089,20834,141439,63262,78177,12673,8905,3768,939,2829,40062,32829,27634
"Shelby, TX",2014,586404,257280,27643,2389,227248,135846,25667,38163,22847,10024,1077,93,8854,5293,556139,297045,76826,55021,21805,182268,98064,84204,12629,8784,3845,929,2916,44037,33817,28877
"Shelby, TX",2015,604245,268913,27261,2934,238718,136529,25503,39591,23693,10544,1069,115,9360,5353,580439,302768,78124,56684,21440,199547,142334,57213,12663,8830,3833,910,2923,45837,34289,19573
"Shelby, TX",2016,493518,283295,28456,3321,251518,143917,25777,35719,19146,10990,1104,129,9757,5583,479319,300559,76403,55154,21249,102357,57359,44998,12508,8700,3808,908,2900,38321,34547,15517
"Shelby, TX",2017,548195,284766,28225,2367,254174,150675,25513,38554,21487,11162,1106,93,9963,5906,532522,309735,79241,56642,22599,143546,101814,41732,12539,8666,3873,902,2971,42469,35741,14046
"St. Charles, LA",2001,959956,166650,18601,2580,145469,163090,48461,26613,19809,3439,384,53,3002,3365,1168451,869983,236353,179402,56951,62115,411,61704,24542,20779,3763,65,3698,47610,41868,16686
"St. Charles, LA",2002,1003634,175598,21265,4263,150070,143900,49117,26938,20434,3575,433,87,3055,2930,1236629,927664,242490,180994,61496,66475,312,66163,25876,21930,3946,52,3894,47791,42301,16991
"St. Charles, LA",2003,1057062,177919,22708,4058,151153,142579,49338,27921,21425,3606,460,82,3064,2890,1291574,958743,260703,196814,63889,72128,396,71732,26701,22493,4208,50,4158,48372,42624,17252
"St. Charles, LA",2004,1140702,196508,25167,3292,168049,154104,49939,29863,22842,3935,504,66,3365,3086,1414985,1045469,275320,207700,67620,94196,226,93970,28023,23507,4516,47,4469,50494,44475,21027
"St. Charles, LA",2005,1199722,252656,43893,13326,195437,177375,50670,32164,23677,4986,866,263,3857,3501,1492111,1115019,288083,219125,68958,89009,50,88959,28541,23690,4851,46,4805,52280,47067,18514
"St. Charles, LA",2006,1371511,240641,28090,3504,209047,227860,52453,35079,26147,4588,536,67,3985,4344,1631724,1189119,317719,243965,73754,124886,197,124689,29692,23958,5734,44,5690,54955,49633,21914
"St. Charles, LA",2007,1452842,252378,29799,2199,220380,288381,52765,37783,27534,4783,565,42,4177,5465,1775931,1327453,331640,251801,79839,116838,-328,117166,31414,25713,5701,47,5654,56533,51626,20723
"St. Charles, LA",2008,1566682,283969,33992,3050,246927,290908,52516,40779,29832,5407,647,58,4702,5539,1941294,1456962,364803,277056,87747,119529,-494,120023,31893,26217,5676,50,5626,60869,55573,21334
"St. Charles, LA",2009,1519304,295102,35323,7817,251962,273902,52719,39612,28819,5598,670,148,4779,5196,1944674,1438685,378245,289508,88737,127744,-442,128186,31190,25497,5693,52,5641,62349,56426,22724
"St. Charles, LA",2010,1551930,323892,38349,9544,275999,230338,52815,39878,29384,6133,726,181,5226,4361,1950755,1401814,392325,305434,86891,156616,-257,156873,30386,24442,5944,55,5889,64199,57353,26638
"St. Charles, LA",2011,1614806,324521,38270,7120,279131,283567,52376,42441,30831,6196,731,136,5329,5414,1989165,1467292,376745,284998,91747,145128,-176,145304,30942,24927,6015,57,5958,64287,58864,24388
"St. Charles, LA",2012,1683502,323246,40111,5206,277929,299942,52432,43994,32108,6165,765,99,5301,5721,2188196,1593422,402651,304649,98002,192123,-274,192397,31693,25574,6119,58,6061,69044,62306,31743
"St. Charles, LA",2013,1675350,338215,37887,3387,296941,282873,52646,43620,31823,6424,720,64,5640,5373,2320474,1691310,448404,343178,105226,180760,-328,181088,32991,26765,6226,56,6170,70337,63191,29350
"St. Charles, LA",2014,1730078,342244,36659,2366,303219,288698,52732,44774,32809,6490,695,45,5750,5475,2417859,1768378,477845,369373,108472,171636,-27,171663,33240,27078,6162,56,6106,72739,65307,28114
"St. Charles, LA",2015,1755308,377721,36704,2803,338214,301360,52647,46240,33341,7175,697,53,6424,5724,2526195,1887201,510342,393207,117135,128652,-159,128811,34461,28357,6104,55,6049,73306,66552,21295
"St. Charles, LA",2016,1705229,400608,39094,3017,358497,327451,52864,46029,32257,7578,740,57,6781,6194,2361926,1744404,491302,383221,108081,126220,-362,126582,32483,26268,6215,54,6161,72713,66408,20546
"St. Charles, LA",2017,1739318,418057,37355,2345,378357,337625,52749,47299,32973,7925,708,44,7173,6401,2406323,1775335,493716,384202,109514,137272,-518,137790,31996,25675,6321,54,6267,75207,69146,21987
"St. Tammany, LA",2001,4460086,727905,54753,9130,664022,1043837,195622,31856,22800,3721,280,47,3394,5336,2536184,1589332,364036,260629,103407,582816,-72,582888,87107,63216,23891,597,23294,29116,25141,25023
"St. Tammany, LA",2002,4729304,793552,64782,15688,713082,1040962,200701,32704,23564,3954,323,78,3553,5187,2799792,1766520,413556,297047,116509,619716,-44,619760,91047,65835,25212,530,24682,30751,26833,25110
"St. Tammany, LA",2003,4944631,802375,69049,14922,718404,1081267,205708,33194,24037,3901,336,73,3492,5256,2956757,1921228,455524,328530,126994,580005,25,579980,94937,68680,26257,504,25753,31144,27974,22521
"St. Tammany, LA",2004,5303834,906050,77516,11841,816693,1122914,211405,34686,25088,4286,367,56,3863,5312,3227961,2097940,505632,369430,136202,624389,-479,624868,98510,71807,26703,480,26223,32768,29216,23829
"St. Tammany, LA",2005,5537370,1228894,204130,28465,996299,1207540,217358,36685,25476,5654,939,131,4584,5556,3486396,2278674,548664,405094,143570,659058,-521,659579,96967,71030,25937,470,25467,35954,32080,25899
"St. Tammany, LA",2006,6105419,1176272,81468,24070,1070734,1550148,223133,39581,27362,5272,365,108,4799,6947,4075962,2650578,609459,442734,166725,815925,2499,813426,106270,75079,31191,453,30738,38355,35304,26463
"St. Tammany, LA",2007,6448333,1215548,90108,8202,1117238,2524832,226294,45024,28495,5372,398,36,4937,11157,4357552,2944049,673431,488436,184995,740072,157,739915,114856,81570,33286,498,32788,37939,36092,22567
"St. Tammany, LA",2008,7076737,1391113,106877,11623,1272613,2193470,229252,46505,30869,6068,466,51,5551,9568,4646158,3039455,674181,485530,188651,932522,-1007,933529,116916,81182,35734,503,35231,39739,37440,26497
"St. Tammany, LA",2009,7060392,1487924,112814,29520,1345590,1848569,231224,44965,30535,6435,488,128,5819,7995,4701814,3056994,696840,506114,190726,947980,755,947225,117468,80452,37016,508,36508,40026,37998,25946
"St. Tammany, LA",2010,7577657,1635567,125750,34982,1474835,1933494,234533,47527,32310,6974,536,149,6288,8244,5254806,3223536,776217,576754,199463,1255053,2916,1252137,118184,80585,37599,509,37090,44463,40002,33759
"St. Tammany, LA",2011,7561210,1682267,128593,27463,1526211,1833635,236780,46782,31933,7105,543,116,6446,7744,5288424,3394942,767048,552866,214182,1126434,2732,1123702,118624,82977,35647,512,35135,44581,40914,31982
"St. Tammany, LA",2012,7959890,1732544,136388,20816,1575340,2320664,239139,50235,33286,7245,570,87,6588,9704,5665844,3586492,801039,576885,224154,1278313,1505,1276808,123201,84846,38355,511,37844,45989,42271,33739
"St. Tammany, LA",2013,8152460,1811251,133919,13880,1663452,2164024,242074,50099,33678,7482,553,57,6872,8940,5926183,3770629,845052,607398,237654,1310502,8381,1302121,126713,86607,40106,502,39604,46769,43537,32879
"St. Tammany, LA",2014,9772767,1863922,137156,9816,1716950,2350399,245511,56971,39806,7592,559,40,6993,9573,7569218,4048356,916643,666180,250463,2604219,5287,2598932,131302,89952,41350,501,40849,57647,45006,63623
"St. Tammany, LA",2015,9417066,2065661,136776,11927,1916958,2376321,249320,55587,37771,8285,549,48,7689,9531,7187559,4244952,973840,709058,264782,1968767,1448,1967319,133212,92484,40728,497,40231,53956,45899,48901
"St. Tammany, LA",2016,9256959,2193493,145049,13031,2035413,2491240,252772,55155,36622,8678,574,52,8052,9856,7001281,4338849,1001547,731389,270158,1660885,2031,1658854,138260,94345,43915,496,43419,50639,45989,38206
"St. Tammany, LA",2017,9381786,2300276,141265,10364,2148647,2583946,256327,55656,36601,8974,551,40,8382,10081,7006621,4435075,1030518,753285,277233,1541028,111,1540917,139582,94855,44727,489,44238,50197,46756,34832
"Taylor, FL",2001,279110,92988,11335,1502,80151,63387,19379,22472,14403,4798,585,78,4136,3271,312948,193053,49798,36499,13299,70097,4341,65756,8085,6837,1248,114,1134,38707,28237,57986
"Taylor, FL",2002,283146,99213,11503,2060,85650,59069,19465,22678,14546,5097,591,106,4400,3035,317768,200257,53531,39917,13614,63980,1973,62007,8266,7041,1225,96,1129,38443,28442,54922
"Taylor, FL",2003,284644,105598,12605,2036,90957,60498,20011,22525,14224,5277,630,102,4545,3023,315739,197240,54733,41233,13500,63766,1454,62312,7861,6688,1173,98,1075,40165,29492,57965
"Taylor, FL",2004,299704,113830,14036,1278,98516,66486,20093,23890,14916,5665,699,64,4903,3309,330800,210065,58776,44240,14536,61959,1687,60272,8362,7066,1296,99,1197,39560,29729,50353
"Taylor, FL",2005,312295,119309,16033,883,102393,72708,20515,24583,15223,5816,782,43,4991,3544,346154,235305,65166,48987,16179,45683,233,45450,8869,7479,1390,102,1288,39030,31462,35287
"Taylor, FL",2006,315606,130286,16359,1048,112879,73757,20793,24992,15178,6266,787,50,5429,3547,348861,242982,63898,46663,17235,41981,-295,42276,8947,7537,1410,102,1308,38992,32239,32321
"Taylor, FL",2007,322846,138872,16799,1010,121063,84840,21805,25066,14806,6369,770,46,5552,3891,358285,264480,69609,51173,18436,24196,-471,24667,9139,7677,1462,122,1340,39204,34451,18408
"Taylor, FL",2008,314820,153682,18335,1902,133445,88108,22356,24898,14082,6874,820,85,5969,3941,347586,264527,70630,51960,18670,12429,-499,12928,8973,7555,1418,129,1289,38737,35014,10029
"Taylor, FL",2009,297760,162207,21799,5060,135348,92027,22482,24553,13244,7215,970,225,6020,4093,338685,254578,67122,49100,18022,16985,-325,17310,8570,7155,1415,137,1278,39520,35580,13545
"Taylor, FL",2010,321222,174632,23371,4947,146314,102266,22587,26481,14222,7732,1035,219,6478,4528,376025,267570,71494,52556,18938,36961,798,36163,8612,7124,1488,145,1343,43663,37559,26927
"Taylor, FL",2011,309002,179615,23929,3846,151840,110400,22652,26444,13641,7929,1056,170,6703,4874,373563,272242,70815,51106,19709,30506,614,29892,8589,7085,1504,154,1350,43493,38425,22142
"Taylor, FL",2012,313320,176291,23156,3038,150097,94158,22750,25660,13772,7749,1018,134,6598,4139,391030,275150,71781,51305,20476,44099,2037,42062,8618,7131,1487,160,1327,45374,38585,31697
"Taylor, FL",2013,309404,183257,23466,2121,157670,88674,22865,25425,13532,8015,1026,93,6896,3878,406777,288515,75485,54438,21047,42777,1586,41191,8756,7265,1491,162,1329,46457,39713,30994
"Taylor, FL",2014,303821,192918,22380,1214,169324,95428,22575,26231,13458,8546,991,54,7501,4227,397265,283211,74402,53874,20528,39652,2557,37095,8754,7190,1564,162,1402,45381,39390,26459
"Taylor, FL",2015,322146,198432,22148,967,175317,102611,22358,27873,14409,8875,991,43,7841,4589,419360,303904,74912,54113,20799,40544,3879,36665,8638,7064,1574,160,1414,48548,43022,25930
"Taylor, FL",2016,300762,206013,21243,521,184249,110243,22118,27897,13598,9314,960,24,8330,4984,388153,284930,71895,51771,20124,31328,2213,29115,8633,7068,1565,159,1406,44962,40313,20708
"Taylor, FL",2017,308912,215571,22355,447,192769,115189,21833,29298,14149,9874,1024,20,8829,5276,393949,292420,73113,52670,20443,28416,2737,25679,8631,7045,1586,159,1427,45643,41507,17995
"Terrebonne, LA",2001,1739113,426527,54219,4383,367925,337523,105255,23782,16523,4052,515,42,3496,3207,2068697,1550441,315551,208391,107160,202705,1207,201498,58775,49631,9144,149,8995,35197,31239,22401
"Terrebonne, LA",2002,1795896,449000,59223,7342,382435,330539,105698,24366,16991,4248,560,69,3618,3127,2121564,1577988,329951,219396,110555,213625,1007,212618,59557,50233,9324,129,9195,35622,31413,23123
"Terrebonne, LA",2003,1844622,461277,62493,7338,391446,330609,106257,24813,17360,4341,588,69,3684,3111,2168048,1624545,353012,239821,113191,190491,767,189724,59733,50352,9381,123,9258,36296,32264,20493
"Terrebonne, LA",2004,1896661,508661,68642,6440,433579,335575,106783,25668,17762,4764,643,60,4060,3143,2214371,1668405,371695,256724,114971,174271,239,174032,60528,50484,10044,120,9924,36584,33048,17536
"Terrebonne, LA",2005,2100358,573760,91198,17273,465289,397206,107811,28488,19482,5322,846,160,4316,3684,2460275,1824398,399309,278572,120737,236568,2085,234483,63248,52626,10622,119,10503,38899,34667,22325
"Terrebonne, LA",2006,2588949,590142,72648,5394,512100,467267,109994,33151,23537,5365,660,49,4656,4248,3076578,2244580,464802,319199,145603,367196,9320,357876,68243,57194,11049,117,10932,45083,39245,32737
"Terrebonne, LA",2007,2881728,623989,73964,3593,546432,586729,110656,36983,26042,5639,668,32,4938,5302,3391412,2497915,498047,338379,159668,395450,1392,394058,71493,60388,11105,130,10975,47437,41364,35905
"Terrebonne, LA",2008,3019682,699509,86767,5477,607265,666546,111453,39351,27094,6276,779,49,5449,5981,3596321,2708193,533291,363376,169915,354837,8913,345924,72088,60687,11401,133,11268,49888,44626,30700
"Terrebonne, LA",2009,2852581,725999,87965,13137,624897,653240,111689,37889,25540,6500,788,118,5595,5849,3478763,2591605,547240,383380,163860,339918,8048,331870,69456,57939,11517,136,11381,50086,44730,29160
"Terrebonne, LA",2010,2979681,790514,99084,16913,674517,500654,111514,38299,26720,7089,889,152,6049,4490,3588210,2622692,577251,410942,166309,388267,11249,377018,69363,57265,12098,138,11960,51731,45799,31523
"Terrebonne, LA",2011,2911586,796477,101162,12205,683110,608045,111593,38677,26091,7137,907,109,6121,5449,3533123,2659975,539361,367827,171534,333787,10785,323002,68533,56728,11805,141,11664,51554,46890,27692
"Terrebonne, LA",2012,3097304,806305,106938,8800,690567,692200,111720,41137,27724,7217,957,79,6181,6196,3830158,2843208,588696,405275,183421,398254,7024,391230,70754,58298,12456,145,12311,54133,48770,31779
"Terrebonne, LA",2013,3248981,849577,106426,5807,737344,615570,112684,41835,28833,7539,944,52,6543,5463,4215862,3137179,628034,424163,203871,450649,6334,444315,73122,60182,12940,142,12798,57655,52128,34718
"Terrebonne, LA",2014,3502388,840807,102516,4069,734222,700963,113512,44437,30855,7407,903,36,6468,6175,4451959,3242705,653927,445960,207967,555327,6683,548644,74220,60989,13231,142,13089,59983,53169,41916
"Terrebonne, LA",2015,3099500,935114,103796,6043,825275,763234,113928,42113,27206,8208,911,53,7244,6699,4194738,3168226,658131,453405,204726,368381,5983,362398,73109,59830,13279,142,13137,57376,52954,27586
"Terrebonne, LA",2016,2686152,1004107,120066,7684,876357,723831,113123,39020,23745,8876,1061,68,7747,6399,3635047,2738676,591046,413370,177676,305325,3855,301470,67666,54703,12963,142,12821,53720,50064,23514
"Terrebonne, LA",2017,2567722,1053017,117491,5515,930011,745879,112086,38958,22908,9395,1048,49,8297,6655,3489281,2641289,588926,416548,172378,259066,2735,256331,65955,52788,13167,139,13028,52904,50036,19675
"Wakulla, FL",2001,429602,72455,8084,1196,63175,88886,23779,24851,18066,3047,340,50,2657,3738,234377,154386,40074,30977,9097,39917,1032,38885,6933,4598,2335,128,2207,33806,33577,17619
"Wakulla, FL",2002,422438,84781,8820,1966,73995,85466,24458,24233,17272,3466,361,80,3025,3494,203459,123507,37130,28513,8617,42822,754,42068,7385,4860,2525,121,2404,27550,25413,17499
"Wakulla, FL",2003,442789,94726,9735,2003,82988,92357,25062,25133,17668,3780,388,80,3311,3685,212782,127476,38854,29989,8865,46452,361,46091,7407,4791,2616,121,2495,28727,26607,18473
"Wakulla, FL",2004,464349,100589,12847,992,86750,101767,25832,25809,17976,3894,497,38,3358,3940,229403,142043,43007,32940,10067,44353,359,43994,7674,5035,2639,116,2523,29894,28211,17437
"Wakulla, FL",2005,497032,107875,13465,737,93673,109200,26706,26740,18611,4039,504,28,3508,4089,249700,158636,47817,36678,11139,43247,105,43142,8475,5435,3040,115,2925,29463,29188,14749
"Wakulla, FL",2006,528738,116328,13534,722,102072,123865,27785,27674,19030,4187,487,26,3674,4458,272033,180098,51251,38348,12903,40684,200,40484,9030,5862,3168,111,3057,30125,30723,13243
"Wakulla, FL",2007,557878,129654,14069,980,114605,138176,28588,28883,19514,4535,492,34,4009,4833,288193,196035,55857,42004,13853,36301,-350,36651,9508,6075,3433,130,3303,30311,32269,11096
"Wakulla, FL",2008,574568,154075,14977,2115,136983,145561,29183,29956,19688,5280,513,72,4694,4988,296955,204265,60909,46585,14324,31781,-687,32468,9391,6030,3361,133,3228,31621,33875,10058
"Wakulla, FL",2009,569873,161979,18253,5452,138274,134574,30459,28446,18710,5318,599,179,4540,4418,289199,190413,58229,44677,13552,40557,-655,41212,9019,5744,3275,136,3139,32066,33150,13129
"Wakulla, FL",2010,584886,175051,21019,6813,147219,136598,30825,29085,18974,5679,682,221,4776,4431,301581,188264,60884,47477,13407,52433,-197,52630,8973,5710,3263,139,3124,33610,32971,16847
"Wakulla, FL",2011,586518,188344,22289,5592,160463,145076,30971,29703,18938,6081,720,181,5181,4684,294569,178760,56487,43469,13018,59322,-441,59763,8908,5467,3441,143,3298,33068,32698,18121
"Wakulla, FL",2012,596519,184895,21591,3742,159562,144108,30853,29998,19334,5993,700,121,5172,4671,290512,172176,54349,41610,12739,63987,197,63790,8635,5242,3393,146,3247,33644,32845,19646
"Wakulla, FL",2013,587066,189663,22182,2313,165168,144154,31000,29706,18938,6118,716,75,5328,4650,286362,183372,57542,44080,13462,45448,-186,45634,8711,5371,3340,147,3193,32874,34141,14292
"Wakulla, FL",2014,607944,206558,21932,1201,183425,151872,31408,30768,19356,6577,698,38,5840,4835,292811,189868,57772,43882,13890,45171,-33,45204,8919,5478,3441,146,3295,32830,34660,13719
"Wakulla, FL",2015,636214,219863,21531,681,197651,158649,31518,32195,20186,6976,683,22,6271,5034,304567,200956,59545,45244,14301,44066,363,43703,8936,5647,3289,145,3144,34083,35586,13900
"Wakulla, FL",2016,673497,228837,20799,494,207544,170365,31885,33643,21123,7177,652,15,6509,5343,316652,212201,60509,45523,14986,43942,318,43624,9034,5824,3210,144,3066,35051,36436,14228
"Wakulla, FL",2017,711154,239140,21545,429,217166,178042,32120,35129,22141,7445,671,13,6761,5543,333315,223180,62754,47137,15617,47381,905,46476,9198,5927,3271,144,3127,36238,37655,14863
"Walker, TX",2001,712634,169336,16097,2179,151060,202522,62444,17367,11412,2712,258,35,2419,3243,825232,603171,161455,127417,34038,60606,4701,55905,27865,23133,4732,1060,3672,29615,26074,15225
"Walker, TX",2002,737258,190037,18514,2746,168777,195315,62216,18044,11850,3054,298,44,2713,3139,871005,627096,175692,140668,35024,68217,7931,60286,28043,23273,4770,1010,3760,31060,26945,16034
"Walker, TX",2003,736300,204105,20865,6884,176356,212720,63609,18128,11575,3209,328,108,2773,3344,886576,630206,185170,148004,37166,71200,7793,63407,27972,23070,4902,999,3903,31695,27317,16246
"Walker, TX",2004,726639,216773,22219,4351,190203,197482,64551,17674,11257,3358,344,67,2947,3059,884794,633426,187637,150114,37523,63731,7175,56556,28483,23304,5179,988,4191,31064,27181,13495
"Walker, TX",2005,743090,234245,25842,3300,205103,217972,65676,18200,11314,3567,393,50,3123,3319,916123,663134,192111,153326,38785,60878,5497,55381,28763,23544,5219,1006,4213,31851,28166,13145
"Walker, TX",2006,767026,254689,27015,2990,224684,224561,65591,19001,11694,3883,412,46,3426,3424,957546,700109,198690,158842,39848,58747,6624,52123,29109,23743,5366,999,4367,32895,29487,11936
"Walker, TX",2007,799552,275098,27629,2971,244498,241683,65517,20091,12204,4199,422,45,3732,3689,987474,735586,199988,158095,41893,51900,3134,48766,29792,23874,5918,1081,4837,33146,30811,10082
"Walker, TX",2008,844807,316449,31753,4737,279959,277419,65726,21889,12853,4815,483,72,4259,4221,1035098,771721,206964,163518,43446,56413,154,56259,30590,24174,6416,1143,5273,33838,31924,10669
"Walker, TX",2009,832190,347360,35457,13040,298863,268418,66748,21693,12468,5204,531,195,4477,4021,1091627,806044,222473,177149,45324,63110,-879,63989,31728,24604,7124,1209,5915,34406,32761,10818
"Walker, TX",2010,839591,384715,41238,14428,329049,286999,68241,22147,12303,5638,604,211,4822,4206,1132135,813721,242680,195736,46944,75734,-1979,77713,31776,24449,7327,1283,6044,35629,33282,12858
"Walker, TX",2011,866234,403372,42612,11957,348803,307184,68408,23050,12663,5897,623,175,5099,4490,1142494,828979,236882,188221,48661,76633,-4824,81457,31384,24160,7224,1354,5870,36404,34312,13877
"Walker, TX",2012,904144,394204,41898,10195,342111,331646,68596,23762,13181,5747,611,149,4987,4835,1193662,852706,254317,203871,50446,86639,-2990,89629,31784,24657,7127,1411,5716,37555,34583,15680
"Walker, TX",2013,954449,410111,42151,7835,360125,346923,69426,24652,13748,5907,607,113,5187,4997,1253115,872563,279412,228535,50877,101140,4925,96215,31722,24601,7121,1418,5703,39503,35469,16871
"Walker, TX",2014,1022090,430818,43358,4253,383207,371736,70001,26066,14601,6154,619,61,5474,5310,1320672,924534,296007,241743,54264,100131,45,100086,32418,25085,7333,1402,5931,40739,36856,16875
"Walker, TX",2015,1029225,458723,42833,5528,410362,382993,70718,26456,14554,6487,606,78,5803,5416,1339535,937369,315845,261033,54812,86321,3454,82867,32557,25197,7360,1377,5983,41144,37202,13850
"Walker, TX",2016,1052165,480660,43626,6153,430881,404844,71701,27024,14674,6704,608,86,6009,5646,1398759,997406,329277,272264,57013,72076,-1144,73220,33501,26043,7458,1372,6086,41753,38298,12031
"Walker, TX",2017,1068679,481861,50264,4555,427042,421921,72245,27302,14792,6670,696,63,5911,5840,1424170,1021809,332626,273159,59467,69735,-2333,72068,33480,25912,7568,1363,6205,42538,39434,11615
"Walton, FL",2001,523838,174646,13471,2232,158943,232676,42391,21966,12357,4120,318,53,3749,5489,499085,317821,75221,53387,21834,106043,-186,106229,18106,12927,5179,567,4612,27565,24586,23033
"Walton, FL",2002,583037,191639,15667,3586,172386,248290,43935,23284,13270,4362,357,82,3924,5651,539146,345267,84875,61175,23700,109004,-5717,114721,18973,13503,5470,517,4953,28416,25570,23162
"Walton, FL",2003,677772,207517,17596,3254,186667,277529,45578,25513,14871,4553,386,71,4096,6089,624395,393370,99165,71833,27332,131860,-2558,134418,20684,14689,5995,535,5460,30187,26780,24619
"Walton, FL",2004,851278,239869,20281,2229,217359,338632,47518,30089,17915,5048,427,47,4574,7126,786816,467748,115872,82990,32882,203196,-744,203940,23578,16710,6868,545,6323,33371,27992,32254
"Walton, FL",2005,976937,251601,22808,1470,227323,394828,49392,32867,19779,5094,462,30,4602,7994,959894,595370,139982,98578,41404,224542,-774,225316,27171,19461,7710,561,7149,35328,30593,31517
"Walton, FL",2006,1094964,270448,22619,1392,246437,468574,51145,35859,21409,5288,442,27,4818,9162,1061495,693035,151364,102090,49274,217096,779,216317,29952,21952,8000,567,7433,35440,31570,29102
"Walton, FL",2007,1064544,281499,22673,2292,256534,538048,52355,35987,20333,5377,433,44,4900,10277,998656,712975,159591,109262,50329,126090,162,125928,30791,21964,8827,686,8141,32433,32461,15468
"Walton, FL",2008,1043386,326586,25577,5072,295937,611861,53563,37000,19480,6097,478,95,5525,11423,933333,668049,156984,109521,47463,108300,942,107358,29547,20675,8872,666,8206,31588,32312,13083
"Walton, FL",2009,1032712,354578,30086,13206,311286,596832,54534,36383,18937,6502,552,242,5708,10944,880501,639530,152250,105284,46966,88721,2926,85795,29203,19874,9329,652,8677,30151,32179,9888
"Walton, FL",2010,1124728,409753,34317,13891,361545,651264,55213,39588,20371,7421,622,252,6548,11795,956738,640144,158507,110785,47722,158087,3054,155033,29153,19751,9402,640,8762,32818,32411,17694
"Walton, FL",2011,1217028,424697,36044,9295,379358,697633,55588,42084,21894,7640,648,167,6824,12550,980061,673388,155571,104883,50688,151102,3535,147567,30490,20560,9930,629,9301,32144,32752,15866
"Walton, FL",2012,1403956,409583,36492,6282,366809,802797,57183,45754,24552,7163,638,110,6415,14039,1113539,732398,164963,109655,55308,216178,6325,209853,31848,21620,10228,607,9621,34964,33876,21812
"Walton, FL",2013,1458790,432111,39264,4548,388299,808484,59179,45614,24650,7302,663,77,6561,13662,1229235,794417,181159,122691,58468,253659,4721,248938,33975,23035,10940,610,10330,36181,34487,24099
"Walton, FL",2014,1594042,475879,41856,2174,431849,925980,61203,48950,26045,7775,684,36,7056,15130,1349576,831073,185344,124481,60863,333159,10981,322178,35293,23637,11656,609,11047,38239,35160,29164
"Walton, FL",2015,1767800,501492,40078,1262,460152,1024093,63087,52204,28022,7949,635,20,7294,16233,1461527,904694,198461,134030,64431,358372,16670,341702,37512,24773,12739,602,12137,38962,36519,28154
"Walton, FL",2016,1925758,534797,38911,990,494896,1182267,65440,55667,29428,8172,595,15,7563,18066,1578245,1002114,209717,139569,70148,366414,4922,361492,40027,26363,13664,599,13065,39430,38012,27669
"Walton, FL",2017,2033207,562905,41571,769,520565,1238153,68376,56076,29736,8232,608,11,7613,18108,1671043,1083289,219964,145242,74722,367790,5908,361882,41093,27147,13946,597,13349,40665,39905,27109
"Harrison, MS",2001,3006585,816684,79416,10276,726992,1032395,190922,25433,15748,4278,416,54,3808,5407,3958236,2967524,689254,469408,219846,301458,-1610,303068,124551,108642,15909,413,15496,31780,27315,19558
"Harrison, MS",2002,3087624,863670,86359,15069,762242,1041491,192145,25984,16069,4495,449,78,3967,5420,4132048,3070015,741281,510483,230798,320752,-2092,322844,123976,107826,16150,367,15783,33329,28472,20455
"Harrison, MS",2003,3205520,913580,94776,14351,804453,1042783,191290,26985,16757,4776,495,75,4205,5451,4349499,3212628,823737,576575,247162,313134,-1631,314765,126179,109517,16662,363,16299,34471,29335,19312
"Harrison, MS",2004,3267510,983857,100643,10689,872525,1007047,195971,26833,16673,5020,514,55,4452,5139,4479262,3286688,871218,612122,259096,321356,-1376,322732,125811,109180,16631,342,16289,35603,30103,19813
"Harrison, MS",2005,3262620,1474574,321718,22248,1130608,958846,197784,28799,16496,7455,1627,112,5716,4848,4600431,3414595,896024,632376,263648,289812,-1388,291200,117826,103307,14519,337,14182,39044,33053,20533
"Harrison, MS",2006,3260669,1088878,97435,17817,973626,1082016,174449,31136,18691,6242,559,102,5581,6202,4593931,3398285,871913,606766,265147,323733,-1059,324792,112813,95438,17375,322,17053,40722,35607,19046
"Harrison, MS",2007,3434297,1032650,105053,9217,918380,1778153,179054,34878,19180,5767,587,51,5129,9931,4948763,3743700,939141,651083,288058,265922,-2553,268475,121329,102826,18503,314,18189,40788,36408,14760
"Harrison, MS",2008,3513065,1175943,111117,13244,1051582,1475812,182735,33736,19225,6435,608,72,5755,8076,5067430,3872024,971645,683209,288436,223761,-2472,226233,122012,103607,18405,305,18100,41532,37372,12499
"Harrison, MS",2009,3562224,1248931,139605,33122,1076204,1439486,184930,33800,19263,6754,755,179,5820,7784,5051594,3787539,985749,689728,296021,278306,-1731,280037,119094,100460,18634,298,18336,42417,37702,15273
"Harrison, MS",2010,3753883,1417256,165397,36445,1215414,1365903,187838,34801,19985,7545,881,194,6471,7272,5177508,3743769,985558,690554,295004,448181,-1572,449753,118388,99022,19366,294,19072,43733,37807,23582
"Harrison, MS",2011,3756880,1496403,175117,30672,1290614,1293229,190928,34288,19677,7838,917,161,6760,6773,5202313,3779849,1000928,688625,312303,421536,-261,421797,120611,99128,21483,288,21195,43133,38131,19901
"Harrison, MS",2012,3808081,1496876,186339,25725,1284812,1409443,193447,34709,19685,7738,963,133,6642,7286,5260624,3796323,1020302,702664,317638,443999,-639,444638,120864,98501,22363,280,22083,43525,38541,20135
"Harrison, MS",2013,3779351,1552904,192236,20135,1340533,1403726,196051,34358,19277,7921,981,103,6838,7160,5205159,3816004,1008222,698460,309762,380933,1372,379561,121322,98291,23031,275,22756,42904,38824,16680
"Harrison, MS",2014,3893202,1618812,193152,10103,1415557,1458494,198218,35166,19641,8167,974,51,7141,7358,5306365,3855767,1029370,720161,309209,421228,-814,422042,121003,97728,23275,273,23002,43853,39454,18348
"Harrison, MS",2015,3923760,1712077,194068,8067,1509942,1481063,200521,35492,19568,8538,968,40,7530,7386,5291341,3854249,996526,688380,308146,440566,-512,441078,120405,97200,23205,267,22938,43946,39653,19229
"Harrison, MS",2016,4005185,1779856,188967,8234,1582655,1502485,202639,35963,19765,8783,933,41,7810,7415,5421097,3943920,1021500,711306,310194,455677,-787,456464,121455,98247,23208,263,22945,44635,40143,19894
"Harrison, MS",2017,4082479,1808339,186401,6958,1614980,1562008,205027,36350,19912,8820,909,34,7877,7619,5565284,4048383,1048106,728406,319700,468795,-854,469649,122512,98949,23563,261,23302,45426,40914,20155
"Hildago, TX",2001,5361436,2204361,518347,52416,1633598,1176921,590067,14816,9086,3736,878,89,2768,1995,6010443,3975628,970233,712372,257861,1064582,99825,964757,220968,178490,42478,2015,40463,27201,22274,23843
"Hildago, TX",2002,5774790,2514520,597071,75369,1842080,1164043,610520,15484,9459,4119,978,123,3017,1907,6461605,4252179,1064983,789383,275600,1144443,91621,1052822,230567,184372,46195,2012,44183,28025,23063,23829
"Hildago, TX",2003,6291768,2739371,668746,102939,1967686,1181287,632475,16147,9948,4331,1057,163,3111,1868,7029078,4566170,1202479,890183,312296,1260429,128921,1131508,242793,192453,50340,1889,48451,28951,23726,23354
"Hildago, TX",2004,6945826,2888404,726990,64635,2096779,1252280,653779,16958,10624,4418,1112,99,3207,1915,7732526,4938922,1302232,964452,337780,1491372,110023,1381349,256668,201839,54829,1821,53008,30127,24470,26059
"Hildago, TX",2005,7412416,3278960,830779,47299,2400882,1392021,674982,17902,10982,4858,1231,70,3557,2062,8254647,5349338,1407152,1035784,371368,1498157,121465,1376692,270969,211622,59347,1789,57558,30463,25278,23918
"Hildago, TX",2006,8051204,3534691,870168,42287,2622236,1431058,695352,18720,11579,5083,1251,61,3771,2058,8913745,5839414,1512949,1118877,394072,1561382,73461,1487921,282999,219210,63789,1725,62064,31497,26638,23974
"Hildago, TX",2007,8362313,3960129,922795,43931,2993403,1566529,715264,19418,11691,5537,1290,61,4185,2190,9272517,6328561,1573826,1148969,424857,1370130,48077,1322053,302755,230039,72716,1809,70907,30627,27511,18645
"Hildago, TX",2008,8690168,4499530,1010481,70503,3418546,1888217,736694,20467,11796,6108,1372,96,4640,2563,9607436,6697520,1617408,1175358,442050,1292508,-6381,1298889,308229,235753,72476,1832,70644,31170,28409,18386
"Hildago, TX",2009,9154579,5001537,1175683,210943,3614911,1835711,757468,21112,12086,6603,1552,278,4772,2423,10085128,6795610,1728527,1271709,456818,1560991,-10015,1571006,310579,234074,76505,1839,74666,32472,29032,21040
"Hildago, TX",2010,9822962,5460066,1300778,258320,3900968,1807671,779015,21939,12609,7009,1670,332,5008,2320,10778285,7006626,1867161,1375982,491179,1904498,20243,1884255,316440,236566,79874,1856,78018,34061,29618,24152
"Hildago, TX",2011,10522930,5587358,1349300,215085,4022973,1953354,794639,22732,13242,7031,1698,271,5063,2458,11345473,7289348,1860106,1348866,511240,2196019,-9158,2205177,329907,241736,88171,1872,86299,34390,30154,25553
"Hildago, TX",2012,11074340,5469461,1362552,188799,3918110,2165539,806725,23192,13728,6780,1689,234,4857,2684,11839087,7544508,1960850,1429179,531671,2333729,-994,2334723,335365,246737,88628,1868,86760,35302,30577,26910
"Hildago, TX",2013,11522266,5588787,1370224,150755,4067808,2152836,817526,23564,14094,6836,1676,184,4976,2633,12373576,7796131,2125313,1578474,546839,2452132,30508,2421624,342957,252185,90772,1893,88879,36079,30914,27246
"Hildago, TX",2014,12134102,5833683,1381870,99010,4352803,2235523,829210,24365,14633,7035,1666,119,5249,2696,12990958,8233253,2219254,1644711,574543,2538451,-7203,2545654,353695,258130,95565,1873,93692,36729,31896,27170
"Hildago, TX",2015,12486092,6160082,1363441,124420,4672221,2373524,840113,25020,14862,7332,1623,148,5561,2825,13433730,8575307,2380186,1782572,597614,2478237,-394,2478631,361691,263555,98136,1869,96267,37141,32537,25747
"Hildago, TX",2016,12561866,6493744,1371587,129732,4992425,2486359,850187,25338,14775,7638,1613,153,5872,2924,13636342,8828216,2442268,1826251,616017,2365858,-8853,2374711,368164,267998,100166,1863,98303,37039,32941,24157
"Hildago, TX",2017,12931351,6508951,1389372,105760,5013819,2607145,860661,25617,15025,7563,1614,123,5826,3029,14041738,9156533,2540978,1896020,644958,2344227,-13916,2358143,374436,272569,101867,1852,100015,37501,33593,23578
"Willacy, TX",2001,160379,95108,19893,2339,72876,38011,20016,14663,8013,4752,994,117,3641,1899,128892,78464,19629,14820,4809,30799,9893,20906,5214,3708,1506,325,1181,24720,21161,17702
"Willacy, TX",2002,165328,105457,21201,3337,80919,35490,20198,15164,8185,5221,1050,165,4006,1757,127802,76877,19985,15187,4798,30940,9073,21867,5152,3532,1620,324,1296,24806,21766,16873
"Willacy, TX",2003,219793,113354,22784,3670,86900,39005,20418,18227,10765,5552,1116,180,4256,1910,179929,81404,22302,16962,5340,76223,54935,21288,5216,3637,1579,297,1282,34496,22382,16605
"Willacy, TX",2004,227065,118636,23301,2366,92969,35614,20767,18362,10934,5713,1122,114,4477,1715,185727,85511,23414,17742,5672,76802,56011,20791,5285,3640,1645,288,1357,35142,23492,15321
"Willacy, TX",2005,204649,129714,26174,1661,101879,37963,21229,17539,9640,6110,1233,78,4799,1788,167824,93682,25146,18665,6481,48996,24918,24078,5596,3821,1775,281,1494,29990,24518,16116
"Willacy, TX",2006,195879,137898,26414,1517,109967,36148,21463,17235,9126,6425,1231,71,5124,1684,159401,101465,26896,19892,7004,31040,4937,26103,5677,3888,1789,273,1516,28078,26097,17218
"Willacy, TX",2007,216575,155520,27308,1526,126686,40587,21576,19127,10038,7208,1266,71,5872,1881,197437,122771,29672,21272,8400,44994,19241,25753,6079,4230,1849,287,1562,32479,29024,16487
"Willacy, TX",2008,208149,168198,29333,2396,136469,45306,21763,19375,9564,7729,1348,110,6271,2082,210220,148084,32676,22891,9785,29460,7607,21853,6546,4655,1891,289,1602,32114,31812,13641
"Willacy, TX",2009,195085,184970,33454,6783,144733,42110,21862,19310,8923,8461,1530,310,6620,1926,198456,143545,34727,24888,9839,20184,-4291,24475,6774,4772,2002,285,1717,29297,30081,14255
"Willacy, TX",2010,265527,202710,36513,8342,157855,40824,22225,22905,11947,9121,1643,375,7103,1837,271931,155146,39216,28119,11097,77569,50087,27482,6889,4785,2104,284,1820,39473,32423,15100
"Willacy, TX",2011,284658,205381,36077,7657,161647,44352,22166,24109,12842,9266,1628,345,7293,2001,281927,162921,37064,25401,11663,81942,50702,31240,6555,4448,2107,283,1824,43009,36628,17127
"Willacy, TX",2012,229260,201429,35768,6792,158869,44867,22198,21423,10328,9074,1611,306,7157,2021,209163,137910,35018,25177,9841,36235,4576,31659,6484,4328,2156,279,1877,32258,31865,16867
"Willacy, TX",2013,241953,207280,36429,5506,165345,46332,22027,22498,10984,9410,1654,250,7506,2103,225127,138801,37112,27351,9761,49214,17196,32018,6491,4324,2167,287,1880,34683,32100,17031
"Willacy, TX",2014,305533,211725,35461,3113,173151,47561,21943,25740,13924,9649,1616,142,7891,2167,285645,147576,39673,29088,10585,98396,64410,33986,6697,4440,2257,283,1974,42653,33238,17217
"Willacy, TX",2015,295913,223589,34718,4228,184643,50796,21882,26062,13523,10218,1587,193,8438,2321,270395,136485,39437,29884,9553,94473,62331,32142,6297,4118,2179,290,1889,42940,33144,17015
"Willacy, TX",2016,298898,235059,34585,4010,196464,52383,21760,26946,13736,10802,1589,184,9029,2407,261555,127888,37385,28513,8872,96282,65310,30972,6001,3949,2052,290,1762,43585,32385,17578
"Willacy, TX",2017,359604,234315,34526,2939,196850,54619,21584,30047,16661,10856,1600,136,9120,2531,326159,130511,39035,29485,9550,156613,127085,29528,5970,3896,2074,287,1787,54633,33499,16524
"Starr, TX",2001,386549,221677,62075,6005,153597,67324,54294,12442,7120,4083,1143,111,2829,1240,396700,204579,61986,49856,12130,130135,11614,118521,17137,11439,5698,877,4821,23149,17884,24584
"Starr, TX",2002,416850,245971,64162,9293,172516,70883,55412,13241,7523,4439,1158,168,3113,1279,425933,220899,69769,56531,13238,135265,10211,125054,18062,12104,5958,863,5095,23582,18250,24544
"Starr, TX",2003,457402,278232,71390,13525,193317,74118,56704,14280,8066,4907,1259,239,3409,1307,463459,242142,79463,64314,15149,141854,12940,128914,18631,12559,6072,855,5217,24876,19280,24710
"Starr, TX",2004,478658,290367,75452,8560,206355,68629,57857,14478,8273,5019,1304,148,3567,1186,482028,256727,85916,69799,16117,139385,9164,130221,19352,13056,6296,861,5435,24908,19664,23960
"Starr, TX",2005,504725,328800,86843,6279,235678,71572,58284,15529,8660,5641,1490,108,4044,1228,499581,278743,91632,73504,18128,129206,7031,122175,19901,13366,6535,884,5651,25103,20855,21620
"Starr, TX",2006,557762,357393,90789,5335,261269,73025,59050,16735,9446,6052,1537,90,4425,1237,540902,306416,100635,80784,19851,133851,6065,127786,20609,13969,6640,887,5753,26246,21935,22212
"Starr, TX",2007,575285,402094,92615,5539,303940,81186,59529,17782,9664,6755,1556,93,5106,1364,530543,320144,101811,80927,20884,108588,170,108418,20924,14093,6831,967,5864,25356,22717,18489
"Starr, TX",2008,628293,441416,97336,8770,335310,102418,59763,19613,10513,7386,1629,147,5611,1714,558642,351270,107946,85317,22629,99426,-200,99626,21272,14627,6645,987,5658,26262,24015,17608
"Starr, TX",2009,625697,490598,113716,27011,349871,102406,60384,20183,10362,8125,1883,447,5794,1696,609607,373705,118187,93404,24783,117715,-70,117785,21698,14988,6710,1000,5710,28095,24934,20628
"Starr, TX",2010,695800,530885,126127,31380,373378,101668,61145,21725,11380,8682,2063,513,6106,1663,671344,394180,131915,104752,27163,145249,-854,146103,21989,15281,6708,1019,5689,30531,25795,25682
"Starr, TX",2011,748925,529456,128166,24152,377138,111378,61582,22568,12161,8598,2081,392,6124,1809,684081,410819,130746,102538,28208,142516,-640,143156,22455,15385,7070,1036,6034,30465,26703,23725
"Starr, TX",2012,795865,509245,125147,20587,363511,119334,61823,23041,12873,8237,2024,333,5880,1930,700688,423164,140061,110545,29516,137463,1266,136197,22702,15910,6792,1040,5752,30865,26597,23678
"Starr, TX",2013,814345,527774,125600,17349,384825,123113,62290,23523,13073,8473,2016,279,6178,1976,729525,440745,155486,124918,30568,133294,13621,119673,22901,16236,6665,1051,5614,31856,27146,21317
"Starr, TX",2014,853734,550054,124955,11994,413105,130748,62914,24391,13570,8743,1986,191,6566,2078,756380,461317,162335,130139,32196,132728,9646,123082,23442,16368,7074,1039,6035,32266,28184,20395
"Starr, TX",2015,858555,582716,123558,16473,442685,137435,63512,24857,13518,9175,1945,259,6970,2164,787592,478097,174349,141475,32874,135146,20961,114185,23533,16489,7044,1034,6010,33468,28995,18999
"Starr, TX",2016,829847,614330,124750,17573,472007,144771,63931,24854,12980,9609,1951,275,7383,2264,775898,489895,178564,145054,33510,107439,3724,103715,24005,16792,7213,1030,6183,32322,29174,16774
"Starr, TX",2017,845783,612795,126373,12690,473732,151546,64454,24981,13122,9507,1961,197,7350,2351,781369,499477,183478,148705,34773,98414,-1047,99461,24213,16896,7317,1024,6293,32271,29562,15805
"Austin, TX",2001,457786,97560,5809,942,90809,148669,24341,28923,18807,4008,239,39,3731,6108,411125,288979,62186,42648,19538,59960,-4347,64307,14468,9100,5368,2185,3183,28416,31756,20203
"Austin, TX",2002,473467,104754,6975,2164,95615,142065,24818,29023,19078,4221,281,87,3853,5724,421660,288301,65190,45582,19608,68169,-281,68450,14543,9211,5332,2062,3270,28994,31300,20933
"Austin, TX",2003,495232,111917,8121,3131,100665,147519,25388,29725,19507,4408,320,123,3965,5811,440107,299077,70314,48791,21523,70716,2562,68154,14672,9248,5424,1960,3464,29996,32340,19675
"Austin, TX",2004,513392,118253,8826,1860,107567,165354,25976,30682,19764,4552,340,72,4141,6366,457259,316353,73897,50819,23078,67009,2349,64660,14956,9477,5479,1888,3591,30574,33381,18006
"Austin, TX",2005,572535,128646,10413,1320,116913,183011,26331,33580,21744,4886,395,50,4440,6950,510268,334356,77814,54672,23142,98098,691,97407,15576,9938,5638,1866,3772,32760,33644,25824
"Austin, TX",2006,656505,138308,11044,1182,126082,209954,26828,37452,24471,5155,412,44,4700,7826,608640,399076,90641,63526,27115,118923,1240,117683,16786,11008,5778,1805,3973,36259,36253,29621
"Austin, TX",2007,696134,150705,10937,1176,138592,237107,27454,39482,25356,5489,398,43,5048,8637,697930,484114,106694,74642,32052,107122,-9676,116798,18243,12276,5967,1903,4064,38257,39436,28740
"Austin, TX",2008,715017,169930,12330,1891,155709,305824,27935,42626,25596,6083,441,68,5574,10948,735109,526602,115278,79943,35335,93229,-10489,103718,19051,12970,6081,1901,4180,38586,40602,24813
"Austin, TX",2009,697792,187894,14817,6558,166519,216344,28254,39004,24697,6650,524,232,5894,7657,746835,536667,122239,84810,37429,87929,-10242,98171,19250,12865,6385,1900,4485,38797,41715,21889
"Austin, TX",2010,713377,204076,16944,7641,179491,197882,28357,39332,25157,7197,598,269,6330,6978,755689,528407,121036,83575,37461,106246,-4468,110714,19084,12505,6579,1910,4669,39598,42256,23713
"Austin, TX",2011,737052,214105,17526,6457,190122,227293,28570,41248,25798,7494,613,226,6655,7956,687952,483324,104292,69587,34705,100336,-12101,112437,17831,11255,6576,1916,4660,38582,42943,24128
"Austin, TX",2012,809086,211300,17199,4577,189524,311244,28516,46698,28373,7410,603,161,6646,10915,719113,482030,102794,68198,34596,134289,-4824,139113,17866,11171,6695,1900,4795,40250,43150,29012
"Austin, TX",2013,864656,221753,16980,3663,201110,233122,28651,46055,30179,7740,593,128,7019,8137,721834,459212,100695,68102,32593,161927,-1100,163027,17670,10955,6715,1918,4797,40851,41918,33985
"Austin, TX",2014,918434,231997,17373,2372,212252,272742,28940,49177,31736,8016,600,82,7334,9424,736458,476372,102159,68777,33382,157927,-4103,162030,17770,10941,6829,1896,4933,41444,43540,32846
"Austin, TX",2015,928420,246899,17275,3047,226577,323158,29447,50887,31529,8385,587,103,7694,10974,766827,485658,105618,71942,33676,175551,14200,161351,18042,11066,6976,1876,5100,42502,43887,31637
"Austin, TX",2016,870330,261246,18264,3705,239277,322415,29637,49060,29366,8815,616,125,8074,10879,711337,480156,105276,71205,34071,125905,10131,115774,18060,11251,6809,1870,4939,39387,42677,23441
"Austin, TX",2017,861189,268248,20987,2520,244741,337895,29786,49262,28913,9006,705,85,8217,11344,715102,501172,109085,72733,36352,104845,7521,97324,18014,11096,6918,1858,5060,39697,45167,19234
"Brazoria, TX",2001,5439026,731177,57201,19857,654119,860790,248280,28319,21907,2945,230,80,2635,3467,3889528,2814728,644775,458056,186719,430025,6056,423969,105976,80538,25438,2476,22962,36702,34949,18464
"Brazoria, TX",2002,5576229,811422,67358,36347,707717,836163,255246,28301,21846,3179,264,142,2773,3276,4012969,2888232,671035,477908,193127,453702,10362,443340,107902,81392,26510,2393,24117,37191,35485,18383
"Brazoria, TX",2003,5671323,877613,80796,37880,758937,894455,261269,28489,21707,3359,309,145,2905,3424,4000855,2855682,705841,506456,199385,439332,17412,421920,108977,80642,28335,2323,26012,36713,35412,16220
"Brazoria, TX",2004,5921145,927675,88312,25118,814245,861700,268051,28765,22090,3461,329,94,3038,3215,4095898,2985183,719948,516362,203586,390767,16517,374250,111190,81234,29956,2255,27701,36837,36748,13510
"Brazoria, TX",2005,6437173,1022267,104250,17395,900622,967000,274336,30716,23465,3726,380,63,3283,3525,4326971,3180225,742678,524796,217882,404068,11847,392221,116257,84319,31938,2257,29681,37219,37717,13215
"Brazoria, TX",2006,7251962,1107005,107657,14405,984943,1101463,284248,33282,25513,3895,379,51,3465,3875,4806101,3541263,803205,564878,238327,461633,6737,454896,122179,88390,33789,2201,31588,39337,40064,14401
"Brazoria, TX",2007,8096675,1220508,109506,14795,1096207,1269504,293296,36096,27606,4161,373,50,3738,4328,5191582,3854975,842173,588132,254041,494434,6301,488133,126522,92000,34522,2344,32178,41033,41902,15170
"Brazoria, TX",2008,8594263,1402216,125649,25175,1251392,1395811,301336,37806,28521,4653,417,84,4153,4632,5519403,4111964,886902,625020,261882,520537,-897,521434,130373,94079,36294,2424,33870,42335,43708,15395
"Brazoria, TX",2009,8377447,1540314,146087,79424,1314803,1283430,309236,36222,27091,4981,472,257,4252,4150,5261406,3818653,883625,632637,250988,559128,-485,559613,128441,90652,37789,2514,35275,40964,42124,15864
"Brazoria, TX",2010,8616424,1735065,169135,92259,1473671,1261667,314453,36931,27401,5518,538,293,4686,4012,5635432,4019702,959294,677717,281577,656436,-4415,660851,129543,91927,37616,2620,34996,43502,43727,18884
"Brazoria, TX",2011,9210474,1807584,175572,73574,1558438,1402967,319274,38904,28848,5662,550,230,4881,4394,6071880,4368396,981544,680139,301405,721940,-5825,727765,133550,94649,38901,2719,36182,45465,46154,20114
"Brazoria, TX",2012,9866809,1804699,176463,58576,1569660,1544291,324433,40735,30412,5563,544,181,4838,4760,6568876,4670395,1050359,728073,322286,848122,6666,841456,138736,99338,39398,2787,36611,47348,47015,22984
"Brazoria, TX",2013,10394594,1886496,176749,45424,1664323,1504191,330170,41752,31483,5714,535,138,5041,4556,7086953,4971183,1148969,809863,339106,966801,13653,953148,143721,102690,41031,2802,38229,49310,48410,24933
"Brazoria, TX",2014,11322332,1998955,183496,28737,1786722,1672477,337782,44389,33520,5918,543,85,5290,4951,7866152,5506798,1247965,881260,366705,1111389,6722,1104667,148828,106667,42161,2769,39392,52854,51626,28043
"Brazoria, TX",2015,11807457,2168520,181663,36240,1950617,1781615,345738,45577,34151,6272,525,105,5642,5153,8400421,5963167,1369147,967932,401215,1068107,4518,1063589,154327,111095,43232,2718,40514,54433,53676,26252
"Brazoria, TX",2016,12070190,2300695,186429,42830,2071436,1814784,353828,45744,34113,6502,527,121,5854,5129,8311541,6062677,1383527,976809,406718,865337,-2582,867919,155504,113446,42058,2710,39348,53449,53441,22058
"Brazoria, TX",2017,12354445,2398010,225656,37936,2134418,1893412,362457,45925,34085,6616,623,105,5889,5224,8624472,6422951,1456616,1027997,428619,744905,-1213,746118,157260,114436,42824,2692,40132,54842,56127,18592
"Fort Bend, TX",2001,11315149,710467,64331,18747,627389,1564385,375708,36172,30117,1891,171,50,1670,4164,6109158,3605059,722504,486379,236125,1781595,14409,1767186,140883,99187,41696,1587,40109,43363,36346,44060
"Fort Bend, TX",2002,11631832,820792,82323,42404,696065,1522950,397943,35120,29230,2063,207,107,1749,3827,6449458,3766650,777887,530244,247643,1904921,11407,1893514,147718,102794,44924,1516,43408,43661,36643,43621
"Fort Bend, TX",2003,11806647,915643,99294,52981,763368,1632241,418747,34280,28195,2187,237,127,1823,3898,6447857,3885980,842865,572918,269947,1719012,19959,1699053,154489,104550,49939,1407,48532,41737,37169,35009
"Fort Bend, TX",2004,12742588,1000126,118477,34243,847406,1786744,441139,35203,28886,2267,269,78,1921,4050,6728203,4191381,897794,607809,289985,1639028,30901,1608127,163350,109047,54303,1323,52980,41189,38436,30353
"Fort Bend, TX",2005,14180491,1177030,162237,27842,986951,2152265,462953,37822,30631,2542,350,60,2132,4649,7721998,4988895,1015831,686648,329183,1717272,35042,1682230,178882,118329,60553,1275,59278,43168,42161,28379
"Fort Bend, TX",2006,16386328,1309214,172268,24764,1112182,2408753,490916,40953,33379,2667,351,50,2266,4907,8693742,5451409,1089824,733603,356221,2152509,49797,2102712,189173,124274,64899,1202,63697,45957,43866,33011
"Fort Bend, TX",2007,18709561,1486754,186589,24856,1275309,2817234,516564,44551,36219,2878,361,48,2469,5454,9770098,6248525,1186239,789667,396572,2335334,27712,2307622,202996,135292,67704,1234,66470,48130,46185,34717
"Fort Bend, TX",2008,21245997,1843028,217970,40367,1584691,3596585,542957,49149,39130,3394,401,74,2919,6624,10722696,6676371,1240135,823150,416985,2806190,26741,2779449,216327,141646,74681,1216,73465,49567,47134,37834
"Fort Bend, TX",2009,20929361,2023935,248805,132423,1642707,3214430,569130,45978,36774,3556,437,233,2886,5648,10288322,6552295,1300085,879431,420654,2435942,8610,2427332,220454,140330,80124,1195,78929,46669,46692,30753
"Fort Bend, TX",2010,22067910,2348596,287759,157978,1902859,3207833,590286,46798,37385,3979,487,268,3224,5434,10801351,6596927,1341676,899871,441805,2862748,9483,2853265,223362,141807,81555,1181,80374,48358,46520,35500
"Fort Bend, TX",2011,23892850,2475483,302298,124004,2049181,3621898,606499,49448,39395,4082,498,204,3379,5972,11154659,7087830,1369196,897183,472013,2697633,-12988,2710621,235073,148564,86509,1164,85345,47452,47709,31761
"Fort Bend, TX",2012,26121188,2510327,308697,102642,2098988,4214500,625394,52521,41768,4014,494,164,3356,6739,11994721,7649126,1466019,958126,507893,2879576,-9607,2889183,244858,156089,88769,1135,87634,48986,49005,32969
"Fort Bend, TX",2013,28411462,2664207,319401,80985,2263821,4355703,652496,54301,43543,4083,490,124,3469,6675,13575086,8407326,1647494,1091252,556242,3520266,14049,3506217,262090,167241,94849,1145,93704,51796,50271,37418
"Fort Bend, TX",2014,32283460,2897821,328241,52004,2517576,4970493,683943,58706,47202,4237,480,76,3681,7267,15821097,8967156,1748069,1161517,586552,5105872,-9939,5115811,274032,175085,98947,1132,97815,57734,51216,52301
"Fort Bend, TX",2015,35482029,3213139,327693,71651,2813795,5271610,713881,61588,49703,4501,459,100,3942,7384,18363322,9408337,1881821,1264393,617428,7073164,-10720,7083884,289300,183620,105680,1119,104561,63475,51238,67749
"Fort Bend, TX",2016,31693628,3476886,345924,89038,3041924,5257779,741958,54489,42716,4686,466,120,4100,7086,14668920,9334076,1892119,1265892,626227,3442725,-29713,3472438,300226,187771,112455,1115,111340,48860,49710,31188
"Fort Bend, TX",2017,32570538,3644749,415453,71871,3157425,5475185,764828,54510,42585,4765,543,94,4128,7159,14876156,9766351,1985593,1317319,668274,3124212,-16146,3140358,307394,192553,114841,1109,113732,48394,50720,27612
"Waller, TX",2001,552617,111995,9855,1360,100780,89704,33747,22352,16375,3319,292,40,2986,2658,423605,291298,68610,49851,18759,63697,1440,62257,15980,11644,4336,1458,2878,26508,25017,21632
"Waller, TX",2002,580562,126058,12179,3026,110853,87794,35060,22659,16559,3595,347,86,3162,2504,458911,306446,75684,56053,19631,76781,9807,66974,16326,11807,4519,1417,3102,28109,25955,21591
"Waller, TX",2003,600075,132966,14255,4246,114465,90605,36333,22669,16516,3660,392,117,3150,2494,512015,352077,87637,63416,24221,72301,12636,59665,16945,12237,4708,1382,3326,30216,28772,17939
"Waller, TX",2004,647859,143419,17576,2741,123102,100570,36850,24202,17581,3892,477,74,3341,2729,531269,364303,91379,66792,24587,75587,13458,62129,17464,12587,4877,1363,3514,30421,28943,17680
"Waller, TX",2005,718088,154310,20389,1967,131954,118471,37242,26606,19282,4143,547,53,3543,3181,631076,429351,106198,77650,28548,95527,6414,89113,19130,13965,5165,1382,3783,32989,30745,23556
"Waller, TX",2006,821204,169345,22670,1764,144911,127006,38260,29209,21464,4426,593,46,3788,3320,740174,486922,116423,84949,31474,136829,8686,128143,19886,14578,5308,1367,3941,37221,33401,32515
"Waller, TX",2007,852773,185236,21133,1751,162352,150966,39809,29867,21422,4653,531,44,4078,3792,795881,538869,117153,82470,34683,139859,4301,135558,19702,14278,5424,1476,3948,40396,37741,34336
"Waller, TX",2008,935955,211089,22837,2782,185470,180527,40578,32717,23066,5202,563,69,4571,4449,902328,594736,122904,85922,36982,184688,3374,181314,20273,14587,5686,1519,4167,44509,40772,43512
"Waller, TX",2009,905845,239337,26764,9064,203509,172271,42087,31303,21523,5687,636,215,4835,4093,864418,563486,125158,89417,35741,175774,7125,168649,20508,14592,5916,1566,4350,42150,38616,38770
"Waller, TX",2010,928116,268854,30302,11444,227108,179978,43513,31645,21330,6179,696,263,5219,4136,891574,578709,134435,96123,38312,178430,4601,173829,21037,14925,6112,1623,4489,42381,38774,38723
"Waller, TX",2011,978551,281014,31903,9084,240027,191323,44088,32909,22195,6374,724,206,5444,4340,943122,639071,141436,99065,42371,162615,9116,153499,21910,15643,6267,1676,4591,43045,40853,33435
"Waller, TX",2012,1047789,274138,31956,7570,234612,206497,44353,34460,23624,6181,720,171,5290,4656,998973,674018,154631,109366,45265,170324,2627,167697,23093,16691,6402,1711,4691,43259,40382,35749
"Waller, TX",2013,1125817,286150,32909,5680,247561,211575,45413,35751,24791,6301,725,125,5451,4659,1073707,707593,169318,121866,47452,196796,13163,183633,24083,17452,6631,1726,4905,44584,40545,37438
"Waller, TX",2014,1228109,298267,33899,3608,260760,239466,46798,37733,26243,6373,724,77,5572,5117,1167106,779309,179216,127898,51318,208581,7025,201556,24634,17897,6737,1707,5030,47378,43544,40071
"Waller, TX",2015,1217279,321109,34423,5012,281674,240218,48639,36567,25027,6602,708,103,5791,4939,1122555,765343,187104,136898,50206,170108,10726,159382,24953,17981,6972,1688,5284,44987,42564,30163
"Waller, TX",2016,1279011,344713,35947,6319,302447,252673,50058,37484,25551,6886,718,126,6042,5048,1069175,748100,183425,133988,49437,137650,2396,135254,25275,17808,7467,1683,5784,42302,42009,23384
"Waller, TX",2017,1307028,353215,39822,4521,308872,264173,51307,37508,25475,6884,776,88,6020,5149,1093997,777034,195437,142247,53190,121526,318,121208,25589,18016,7573,1671,5902,42753,43130,20537
"San Patricio, TX",2001,903779,269394,35112,4862,229420,206854,66690,20693,13552,4039,526,73,3440,3102,791007,582247,146485,105689,40796,62275,2942,59333,25774,20005,5769,580,5189,30690,29105,11434
"San Patricio, TX",2002,959395,291591,38907,6873,245811,202378,66820,21750,14358,4364,582,103,3679,3029,860697,632567,159665,116386,43279,68465,3525,64940,26168,20365,5803,564,5239,32891,31061,12395
"San Patricio, TX",2003,1056230,308263,43463,8776,256024,199022,66440,23533,15898,4640,654,132,3853,2996,971903,676381,185836,136200,49636,109686,39664,70022,27143,21069,6074,532,5542,35807,32103,12635
"San Patricio, TX",2004,1075995,327541,46308,6818,274415,219522,66990,24228,16062,4889,691,102,4096,3277,943025,655317,184820,136641,48179,102888,38783,64105,26386,20376,6010,521,5489,35740,32161,11679
"San Patricio, TX",2005,1105688,356433,50392,4990,301051,247341,67232,25426,16446,5302,750,74,4478,3679,919956,659726,183683,134810,48873,76547,20216,56331,26153,19844,6309,521,5788,35176,33246,9732
"San Patricio, TX",2006,1205476,382476,49832,3808,328836,245561,67022,27357,17986,5707,744,57,4906,3664,1011244,740572,199178,144417,54761,71494,-13589,85083,26472,20128,6344,510,5834,38201,36793,14584
"San Patricio, TX",2007,1314586,417134,49774,3807,363553,268103,66723,29972,19702,6252,746,57,5449,4018,1108998,787936,204837,147354,57483,116225,30499,85726,27694,20899,6795,544,6251,40045,37702,13714
"San Patricio, TX",2008,1370791,462946,53520,5822,403604,309773,66417,32274,20639,6970,806,88,6077,4664,1160346,847915,207060,148310,58750,105371,11859,93512,28554,21532,7022,562,6460,40637,39379,14476
"San Patricio, TX",2009,1308677,494797,58228,17731,418838,293359,65751,31891,19904,7525,886,270,6370,4462,1127533,823167,205911,148338,57573,98455,1835,96620,27983,20779,7204,575,6629,40293,39615,14575
"San Patricio, TX",2010,1391014,548856,65076,22269,461511,285558,64430,34540,21590,8519,1010,346,7163,4432,1144594,792478,203389,145102,58287,148727,35159,113568,27088,19617,7471,591,6880,42255,40398,16507
"San Patricio, TX",2011,1541584,553799,66097,15799,471903,318125,64455,37445,23917,8592,1025,245,7321,4936,1243973,848987,207577,143552,64025,187409,43141,144268,27785,20208,7577,606,6971,44771,42012,20695
"San Patricio, TX",2012,1660992,553171,65186,12254,475731,341066,65265,39152,25450,8476,999,188,7289,5226,1345073,953169,236600,164547,72053,155304,3396,151908,29558,21821,7737,617,7120,45506,43681,21335
"San Patricio, TX",2013,1784104,561564,63601,9939,488024,350196,66134,40764,26977,8491,962,150,7379,5295,1427802,966220,246358,174687,71671,215224,33267,181957,29787,21935,7852,624,7228,47934,44049,25174
"San Patricio, TX",2014,1830529,592578,64834,6712,521032,382095,66638,42096,27470,8892,973,101,7819,5734,1442143,1009106,254462,180662,73800,178575,-8105,186680,30350,22457,7893,617,7276,47517,44935,25657
"San Patricio, TX",2015,1808827,635626,65366,10218,560042,366958,67084,41909,26964,9475,974,152,8348,5470,1391448,997846,256154,183783,72371,137448,-15236,152684,29855,21806,8049,614,7435,46607,45760,20536
"San Patricio, TX",2016,1760812,670551,66973,12858,590720,371131,67262,41665,26178,9969,996,191,8782,5518,1404255,1048316,263371,186287,77084,92568,-21198,113766,29568,22200,7368,612,6756,47492,47221,16839
"San Patricio, TX",2017,1804584,690249,78674,9825,601750,385470,67215,42852,26848,10269,1170,146,8953,5735,1436147,1073987,266740,184930,81810,95420,407,95013,29597,22084,7513,609,6904,48523,48632,13762
"Nueces, TX",2001,5619769,1268530,163002,24518,1081010,1402955,313670,26433,17916,4044,520,78,3446,4473,6689156,4543010,1083254,777143,306111,1062892,2622,1060270,183482,154237,29245,668,28577,36457,29455,37102
"Nueces, TX",2002,5760624,1382154,180288,35521,1166345,1359786,316256,26885,18215,4370,570,112,3688,4300,6882335,4633384,1098566,782524,316042,1150385,7040,1143345,183916,153694,30222,642,29580,37421,30147,38653
"Nueces, TX",2003,6053138,1474464,198243,44723,1231498,1399142,317632,28104,19057,4642,624,141,3877,4405,7258270,4776274,1202650,857584,345066,1279346,49541,1229805,185613,153591,32022,601,31421,39104,31097,39140
"Nueces, TX",2004,6433297,1552833,210182,32296,1310355,1369806,321879,29067,19987,4824,653,100,4071,4256,7787981,5033606,1254085,893252,360833,1500290,74006,1426284,187222,154712,32510,588,31922,41598,32535,44680
"Nueces, TX",2005,6844490,1702857,238171,23202,1441484,1557213,325515,31042,21027,5231,732,71,4428,4784,8317433,5319557,1326035,939688,386347,1671841,20564,1651277,191210,157733,33477,582,32895,43499,33725,50198
"Nueces, TX",2006,7322051,1807687,242344,20190,1545153,1652004,329113,32760,22248,5493,736,61,4695,5020,9028555,5787346,1449473,1042333,407140,1791736,6268,1785468,194863,160350,34513,569,33944,46333,36092,52600
"Nueces, TX",2007,7258327,1988433,249372,19954,1719107,1833363,330512,33524,21961,6016,755,60,5201,5547,9131871,6185886,1450048,1020151,429897,1495937,21091,1474846,200607,162774,37833,604,37229,45521,38003,39616
"Nueces, TX",2008,8075576,2207779,272380,28713,1906686,2046758,333526,36969,24213,6620,817,86,5717,6137,10197271,6611534,1502536,1050446,452090,2083201,543,2082658,204763,166826,37937,619,37318,49800,39631,55808
"Nueces, TX",2009,7431889,2393428,310910,76478,2006040,1809166,338220,34399,21974,7077,919,226,5931,5349,9351831,6317355,1540815,1100631,440184,1493661,11181,1482480,201577,162744,38833,628,38205,46393,38818,38803
"Nueces, TX",2010,7944903,2640732,342464,93630,2204638,1899860,340261,36694,23349,7761,1006,275,6479,5584,9860257,6451260,1615965,1141955,474010,1793032,125032,1668000,201378,162812,38566,641,37925,48964,39624,43982
"Nueces, TX",2011,8700808,2721020,351356,77483,2292181,2112276,343225,39432,25350,7928,1024,226,6678,6154,10454750,6760586,1613456,1122109,491347,2080708,157433,1923275,203843,163334,40509,653,39856,51288,41391,48256
"Nueces, TX",2012,9130523,2685752,348137,62546,2275069,2355095,347848,40740,26249,7721,1001,180,6540,6770,10909685,7286163,1718684,1191015,527669,1904838,21198,1883640,208837,167234,41603,654,40949,52240,43569,46000
"Nueces, TX",2013,9585327,2768198,353282,47433,2367483,2287483,352781,41502,27171,7847,1001,134,6711,6484,11512747,7543747,1836631,1293456,543175,2132369,83476,2048893,213644,171345,42299,662,41637,53888,44027,49208
"Nueces, TX",2014,10015363,2907274,351638,30673,2524963,2541875,356452,43385,28097,8156,986,86,7084,7131,12064361,8083996,1933240,1358200,575040,2047125,29894,2017231,217758,174700,43058,654,42404,55403,46274,47572
"Nueces, TX",2015,9709926,3082429,351432,40386,2690611,2563648,360437,42604,26939,8552,975,112,7465,7113,11832462,8138688,2010003,1428996,581007,1683771,-12012,1695783,218794,175302,43492,651,42841,54080,46427,39583
"Nueces, TX",2016,9080964,3251115,353566,47946,2849603,2363171,361529,40647,25118,8993,978,133,7882,6537,11238422,8026685,1994697,1419239,575458,1217040,32813,1184227,216527,174483,42044,649,41395,51903,46003,28608
"Nueces, TX",2017,9317128,3341860,411601,38567,2891692,2466418,361221,41873,25793,9252,1139,107,8005,6828,11525524,8224208,2037468,1437181,600287,1263848,76470,1187378,217453,174433,43020,646,42374,53002,47148,28021